have | есть
say | сказать
get | получить
make | сделать
see | видеть
know | знаю
time | время
take | принять
year | год
think | думать
come | пришел
last | последний
other | другие
give | дать
people | люди
new | новый
way | путь
look | смотреть
use | используйте
good | хорошо
find | найти
man | человек
want | хотеть
day | день
thing | вещь
tell | сказать
child | ребенок
put | положить
work | работы
become | стать
old | старый
government | правительство
mean | имею в виду
part | часть
leave | оставьте
life | жизнь
great | большой
case | случае
woman | женщина
seem | кажутся
work | работы
need | нужно
feel | чувствовать
system | система
may | может
ask | спросить
group | группы
number | номер
world | мир
area | площадь
show | показать
course | курс
company | компания
problem | проблема
service | услуги
try | попробуйте
call | вызов
hand | рука
party | партии
high | высокий
school | школа
small | небольшие
place | место
keep | сохранить
point | точка
house | дом
different | разные
country | страна
provide | предоставить
week | неделя
hold | удерживайте
large | большой
member | член
follow | следуйте
turn | очередь
end | конец
local | местные
bring | привести
word | слово
begin | начать
example | пример
family | семья
fact | факт
like | как
social | социальной
write | написать
state | государство
percent | процентов
start | Пуск
run | запустить
long | долго
set | установите
help | помощь
home | домой
month | месяц
side | сторона
night | ночь
important | важно
eye | глаз
head | голова
information | информация
question | вопрос
business | бизнес
play | играть
power | питание
money | деньги
change | изменить
move | переместить
interest | интерес
order | заказ
book | книги
development | развития
young | молодых
national | Национальный
pay | платить
hear | услышать
room | номер
water | вода
form | форма
car | автомобиль
other | другие
meet | встретиться
level | уровень
policy | политика
include | включить
believe | верю
council | Совет
possible | возможно
line | линия
allow | разрешить
need | нужно
effect | эффект
big | большой
use | используйте
lead | свинец
stand | стенд
idea | идея
study | исследование
lot | много
live | жить
job | задания
name | имя
result | результат
body | тело
happen | произойдет
friend | друг
right | право
right | право
carry | нести
authority | орган
early | рано
view | вид
public | общественного
talk | говорить
report | отчет
only | только
bit | бит
face | лицо
sit | сидеть
market | рынок
appear | появляются
continue | продолжить
able | состоянии
political | политические
hour | час
rate | ставка
law | закон
door | дверь
court | суд
office | офис
let | пусть
war | война
produce | производим
reason | причина
minister | министр
subject | тема
person | человек
term | срок
particular | частности
full | полный
involve | привлекать
sort | сортировка
require | требуют
suggest | предлагаю
far | далеко
period | период
consider | рассмотреть
read | читать
change | изменить
society | общество
process | процесс
mother | мать
offer | предлагаем
late | поздно
voice | голос
police | полиция
kind | вид
lose | потерять
add | добавить
expect | ожидать
available | доступный
price | цена
little | мало
action | действие
issue | вопрос
remember | помните
position | должность
low | низкий
cost | стоимость
matter | вопрос
community | сообщества
remain | остаются
figure | рис.
type | тип
research | исследования
education | образование
fall | осень
speak | говорить
few | несколько
open | откройте
bad | плохо
buy | купить
programme | программы
minute | минуту
moment | момент
girl | девушка
age | возраст
centre | центр
stop | стоп
control | управления
value | значение
send | отправить
health | здоровье
decide | решение
main | главная
win | победа
understand | понять
decision | решение
develop | разработка
class | класс
industry | промышленность
receive | получать
back | назад
return | возвращение
build | строить
spend | тратить
force | сила
condition | состояние
paper | бумага
major | майор
describe | описать
agree | согласен
economic | экономического
increase | увеличить
learn | узнать
general | общие
father | отец
section | раздел
patient | пациент
activity | деятельности
road | дорога
table | Таблица
church | церковь
reach | достижения
real | реальные
lie | ложь
mind | разум
likely | скорее всего,
team | команда
experience | опыт
death | смерть
act | акт
sense | смысл
staff | персонал
certain | некоторые
student | студент
language | язык
walk | прогулка
die | умереть
special | специальные
difficult | трудно
international | международные
department | отдел
management | управление
morning | утро
draw | рисовать
hope | надежда
plan | план
product | продукт
city | город
committee | Комитет
ground | земля
letter | письмо
create | создать
evidence | доказательства
foot | лапки
clear | ясно
boy | мальчик
game | игры
food | еда
role | роль
practice | практика
bank | Банк
support | поддержка
sell | продать
event | событие
building | здание
range | диапазон
sure | уверены, что
report | отчет
pass | пройти
black | черный
stage | этап
meeting | встреча
accept | принять
town | город
art | искусство
club | клуб
cause | причиной
arm | рука
history | история
parent | родитель
land | земля
trade | торговля
watch | смотреть
white | белый
situation | ситуация
teacher | учитель
record | запись
manager | менеджер
relation | связи
common | общие
strong | сильные
whole | всего
field | поле
free | бесплатно
break | перерыв
support | поддержка
window | окно
account | учетная запись
explain | объяснить
stay | пребывание
wait | подождите,
difference | разница
material | материал
air | воздух
wife | жена
cover | крышка
apply | применить
project | проект
raise | поднять
sale | продажи
relationship | отношения
light | свет
claim | претензии
form | форма
base | база
care | уход
rule | правило
cut | вырезать
grow | расти
similar | похожие
story | история
quality | качество
tax | налог
worker | работник
nature | природа
structure | структура
data | данные
necessary | необходимо
pound | фунт
method | метод
unit | единица
central | Центральной
bed | кровать
union | Союз
movement | движение
board | доска
true | true
well | хорошо
contain | содержать
open | откройте
short | короткий
personal | личные
detail | подробно
model | модель
bear | медведь
single | одноместный
join | присоединиться
reduce | уменьшить
establish | установить
wall | стены
face | лицо
easy | легкая
private | частные
computer | компьютер
hospital | больница
chapter | глава
scheme | схема
theory | теория
choose | выбрать
wish | желание
property | недвижимость
achieve | достижения
financial | финансовые
poor | бедный
officer | офицер
charge | заряд
director | директор
drive | привод
deal | сделка
place | место
approach | подход
chance | шанс
application | приложения
seek | искать
foreign | иностранных
top | топ
amount | сумма
son | сын
operation | операция
fail | провал
human | человека
opportunity | возможность
simple | простой
leader | лидер
look | смотреть
share | доля
production | производство
recent | последние
firm | фирма
picture | изображения
source | источник
security | безопасности
serve | служить
end | конец
contract | контракт
wide | широкий
occur | происходят
agreement | соглашение
kill | убить
act | акт
site | сайт
labour | труда
plan | план
various | различные
test | тест
eat | есть
loss | убыток
close | закрыть
represent | представляют
love | любовь
colour | цвет
shop | магазин
benefit | выгоды
animal | животное
heart | сердце
election | выборы
purpose | цель
standard | стандарт
due | из-за
secretary | секретарь
rise | рост
date | Дата
hard | жесткий
music | музыка
hair | волосы
prepare | подготовить
factor | фактор
pattern | шаблон
manage | управление
piece | кусок
discuss | обсудить
prove | доказать
front | фронт
evening | вечер
royal | royal
tree | дерево
population | население
fine | штраф
plant | завод
pressure | давление
response | ответ
catch | улов
street | улица
pick | выбрать
performance | производительность
knowledge | знания
design | дизайн
page | стр.
enjoy | наслаждайтесь
individual | индивидуальные
suppose | предположим, что
rest | отдых
wear | носить
basis | основе
size | размер
environment | среда
fire | огонь
series | серия
success | успех
natural | природных
wrong | неправильный
thought | мысль
list | список
argue | спорить
final | финал
future | будущее
introduce | ввести
analysis | анализ
enter | введите
space | пространство
arrive | прибытие
ensure | обеспечения
demand | спрос
statement | заявление
attention | внимание
love | любовь
principle | принцип
pull | тянуть
set | установите
doctor | доктор
choice | выбор
refer | см.
feature | функция
couple | пара
step | шаг
following | после
thank | спасибо
machine | машина
income | доход
training | обучение
present | настоящее
association | ассоциации
film | фильм
region | регион
effort | усилие
player | игрок
present | настоящее
award | награды
village | деревня
control | управления
organisation | организация
news | Новости
nice | Ницца
difficulty | трудность
modern | современные
cell | ячейки
close | закрыть
current | ток
legal | юридических
energy | энергии
degree | степень
mile | мили
means | означает
growth | рост
treatment | лечение
sound | звук
task | задача
provision | положение
affect | влияет на
red | красный
happy | счастлив
behaviour | поведение
concerned | заинтересованными
point | точка
function | функция
identify | определить
resource | ресурс
defence | обороны
garden | сад
floor | пол
technology | технологии
style | стиль
feeling | чувство
science | наука
relate | относятся
doubt | сомнения
horse | лошадь
force | сила
answer | ответ
compare | сравнить
suffer | страдать
individual | индивидуальные
announce | объявить
user | пользователь
fund | фонд
character | характер
risk | риск
normal | нормальный
dog | собака
obtain | получить
army | армия
indicate | указать
forget | забыть
station | станции
glass | стекло
cup | Кубок
previous | предыдущий
husband | муж
publish | опубликовать
serious | серьезные
visit | посетите
capital | капитал
note | Примечание
season | сезон
argument | аргумент
listen | слушать
show | показать
responsibility | ответственность
significant | существенное
deal | сделка
prime | премьер -
economy | экономика
element | элемент
finish | закончить
duty | долг
fight | бой
train | поезд
maintain | поддерживать
attempt | попытка
leg | матч
investment | инвестиции
save | сохранить
design | дизайн
brother | брат
improve | улучшить
avoid | избежать
wonder | чудо
title | название
hotel | hotel
aspect | аспект
increase | увеличить
help | помощь
industrial | промышленные
express | Экспресс
summer | лето
determine | определения
daughter | дочь
exist | существуют
share | доля
baby | ребенок
smile | улыбка
sorry | извините
sea | море
skill | мастерство
claim | претензии
treat | лечить
remove | удалить
concern | концерн
university | университет
labour | труда
left | слева
dead | мертвые
discussion | обсуждение
specific | конкретные
customer | клиентов
box | окне
state | государство
conference | конференции
whole | всего
total | Итого
profit | прибыль
division | отдел
throw | бросить
procedure | процедура
fill | заполните
king | король
assume | предположим
image | изображения
oil | нефть
appropriate | соответствующие
circumstance | обстоятельство
military | военные
proposal | предложение
mention | упоминание
client | клиент
sector | сектор
direction | направление
admit | признать
replace | заменить
basic | основные
instance | экземпляр
sign | знак
original | оригинал
successful | успешного
reflect | отражения
aware | знать
measure | мера
attitude | отношение
disease | болезнь
commission | комиссия
intend | намерены
seat | кресло
president | президент
encourage | поощрения
addition | дополнение
goal | цель
miss | мисс
popular | популярные
affair | Роман
technique | техника
respect | уважение
drop | падение
professional | профессиональные
item | пункт
fly | летать
reveal | открыть
version | версия
ability | способность
operate | работать
good | хорошо
campaign | кампания
heavy | тяжелые
advice | советы
institution | учреждение
top | топ
discover | найдите
surface | поверхности
library | библиотека
pupil | ученик
record | запись
refuse | отказаться
prevent | предотвратить
advantage | преимущество
dark | темные
teach | учить
memory | память
culture | культура
blood | кровь
cost | стоимость
majority | большинство
answer | ответ
variety | разнообразие
press | нажмите
depend | зависеть
bill | Билл
competition | конкурс
ready | готов
general | общие
access | доступ
hit | хит
stone | камень
useful | полезное
extent | степени
employment | занятости
regard | связи
present | настоящее
appeal | обращение
text | текст
parliament | парламент
cause | причиной
terms | условия
bar | бар
attack | нападение
effective | эффективные
mouth | рот
result | результат
fish | рыбы
future | будущее
visit | посетите
attempt | попытка
enable | включить
trouble | беда
traditional | традиционные
payment | оплата
post | должность
county | округа
lady | леди
holiday | holiday
realise | реализовать
importance | значение
chair | стул
facility | центр
complete | полный
article | статьи
object | объект
context | контекст
survey | опрос
notice | уведомления
complete | полный
turn | очередь
direct | прямой
collection | коллекция
reference | ссылки
card | карты
interesting | интересно
considerable | значительный
television | телевидение
extend | продлить
communication | коммуникации
agency | агентство
physical | физической
check | проверьте
sun | солнце
species | виды
possibility | возможность
official | официальный
chairman | председатель
speaker | динамик
second | второй
career | карьера
laugh | смеяться
weight | вес
sound | звук
responsible | ответственность
base | база
document | документ
solution | решение
return | возвращение
medical | медицинские
hot | горячий
recognise | признать
talk | говорить
budget | бюджет
river | река
fit | fit
organization | организация
existing | существующих
start | Пуск
push | нажмите
requirement | требования
cold | холодной
edge | edge
opposition | оппозиция
opinion | мнение
drug | наркотиков
quarter | квартал
option | опция
sign | знак
call | вызов
define | определить
stock | акции
influence | влияние
occasion | случаю
software | программное обеспечение
exchange | обмен
lack | недостаток
shake | shake
study | исследование
concept | концепция
blue | синий
star | звезда
radio | радио
arrangement | расположение
examine | изучить
bird | птица
green | зеленый
band | группы
sex | секс
finger | палец
past | прошлое
independent | независимых
equipment | оборудование
north | север
mind | разум
move | переместить
message | сообщение
fear | страх
afternoon | день
drink | пить
race | гонки
gain | прибыль
strategy | стратегия
extra | дополнительные
scene | сцена
kitchen | кухня
speech | речи
arise | возникают
network | сети
tea | чай
peace | мир
failure | провал
employee | работник
scale | шкалы
attend | посещать
shoulder | плечо
railway | железнодорожная
supply | предложения
expression | выражение
owner | владелец
associate | связать
corner | угол
past | прошлое
match | матч
sport | спорт
status | статус
beautiful | красивые
offer | предлагаем
marriage | брак
hang | повесить
civil | гражданского
perform | выполнить
sentence | приговор
crime | преступление
ball | шар
marry | жениться
wind | ветер
truth | истина
protect | защитить
safety | безопасность
partner | партнер
copy | копировать
balance | баланс
sister | сестра
reader | читатель
trial | испытание
rock | рок
damage | ущерб
adopt | принять
newspaper | газета
meaning | значение
light | свет
essential | важно
obvious | очевидно
nation | нация
confirm | подтвердить
south | Южной
length | длина
branch | филиал
deep | глубоко
planning | планирование
trust | доверие
working | Рабочая
pain | боль
studio | студия
positive | положительные
spirit | дух
college | колледж
accident | несчастный случай
star | звезда
hope | надежда
mark | Марк
works | работ
league | Чемпионат
clear | ясно
imagine | представьте себе
cash | денежные средства
play | играть
strength | прочность
train | поезд
travel | путешествия
target | цель
very | очень
pair | пара
male | мужской
gas | газ
issue | вопрос
contribution | вклад
complex | комплекс
supply | предложения
beat | бить
artist | художник
agent | агент
presence | присутствие
environmental | окружающей среды
strike | забастовка
contact | контакт
protection | защита
beginning | начало
demand | спрос
media | СМИ
relevant | соответствующих
employ | использовать
shoot | стрелять
executive | исполнительный
aid | помощь
huge | огромные
speed | скорость
review | обзор
test | тест
order | заказ
route | маршрут
consequence | следствие
telephone | телефон
release | релиз
proportion | пропорции
primary | первичной
consideration | внимание
reform | реформы
driver | драйвер
annual | годовой
nuclear | ядерный
practical | практические
commercial | коммерческой
rich | богатые
emerge | выйти
ring | кольцо
distance | расстояние
exercise | упражнение
key | ключ
skin | кожа
island | остров
separate | отдельный
aim | цель
danger | опасность
credit | кредит
usual | обычно
link | ссылке
candidate | кандидат
track | трек
safe | надежно
interested | заинтересованы
assessment | оценки
path | путь
district | район
regular | регулярные
reaction | реакция
impact | влияние
collect | собирать
debate | дискуссии
lay | лежал
rise | рост
belief | вера
conclusion | заключение
shape | форма
vote | голосование
aim | цель
politics | политика
reply | ответ
press | нажмите
approach | подход
file | файл
western | Западной
earth | земля
public | общественного
survive | выжить
estate | недвижимости
boat | лодка
prison | тюрьма
additional | дополнительные
settle | зачет
wine | вино
observe | наблюдать
limit | предел
deny | отрицать
writer | писатель
weekend | выходные
clothes | одежда
active | активный
sight | зрение
video | видео
reality | реальность
hall | зал
regional | региональные
vehicle | автомобиль
worry | беспокоиться
powerful | мощный
cross | крест
colleague | коллега
charge | заряд
lead | свинец
farm | - ферма
respond | ответить
employer | работодатель
understanding | понимание
connection | соединение
comment | комментарий
grant | грант
concentrate | концентрат
ignore | игнорировать
phone | телефон
hole | отверстие
insurance | страхование
content | содержание
confidence | доверие
sample | образец
transport | транспорт
objective | цель
alone | один
flower | цветок
injury | травмы
lift | Лифт
stick | stick
front | фронт
battle | битва
generation | поколение
winter | зима
impossible | невозможно
arrange | организовать
will | будет
sleep | сон
progress | прогресс
volume | объем
ship | корабль
legislation | законодательство
commitment | обязательство
conflict | конфликт
bag | мешок
fresh | свежие
entry | вступление
smile | улыбка
fair | ярмарка
promise | обещание
introduction | введение
senior | старший
manner | образом
background | фон
key | ключ
touch | touch
vary | различаются
sexual | сексуальные
ordinary | обыкновенные
cabinet | кабинет
painting | живопись
engine | двигатель
administration | администрация
adult | взрослый
prefer | предпочитают
author | автор
actual | фактические
song | песня
investigation | расследование
debt | долг
visitor | посетитель
forest | лес
repeat | повторите
wood | дерево
contrast | контраст
wage | заработной платы
domestic | домашние
commit | совершить
threat | угрозы
bus | автобус
warm | теплый
sir | сэр
regulation | регулирование
drink | пить
relief | рельеф
internal | внутренние
strange | странно
excellent | отлично
run | запустить
technical | технические
tradition | традиции
measure | мера
insist | настаивать
farmer | фермер
traffic | трафик
dinner | ужин
consumer | потребитель
meal | обед
warn | предупредить
living | жизни
package | пакет
half | половина
description | описание
soft | мягкие
stuff | материал
award | награды
existence | существование
improvement | улучшение
coffee | кофе
appearance | внешний вид
standard | стандарт
attack | нападение
sheet | лист
category | категории
distribution | распределение
session | сессии
cultural | культурных
loan | кредит
bind | bind
museum | музей
conversation | разговор
threaten | угрожать
link | ссылке
launch | запустить
proper | правильное
victim | жертва
audience | аудитория
famous | известный
master | мастер
lip | губа
religious | религиозные
joint | совместных
cry | крик
potential | потенциал
broad | широкие
exhibition | выставка
experience | опыт
judge | судья
formal | официальные
housing | корпус
concern | концерн
freedom | свобода
gentleman | джентльмен
attract | привлечь
explanation | объяснение
appoint | назначить
note | Примечание
chief | главный
total | Итого
lovely | прекрасный
official | официальный
date | Дата
demonstrate | продемонстрировать
construction | строительство
middle | средний
yard | двор
unable | не в состоянии
acquire | приобрести
crisis | кризис
west | Запад
impose | навязать
market | рынок
care | уход
god | Бог
favour | пользу
name | имя
equal | равные
capacity | емкость
flat | квартира
selection | выбор
football | футбол
victory | победа
factory | фабрика
rural | сельских
sing | петь
own | собственные
head | голова
examination | изучение
deliver | доставить
substantial | существенные
invite | приглашаем
intention | намерение
egg | яйцо
reasonable | разумные
retain | сохранить
aircraft | воздушных судов
decade | десятилетие
cheap | дешевые
quiet | тихо
bright | яркие
contribute | вклад
row | строки
search | поиск
limit | предел
definition | определение
unemployment | безработица
spread | распространение
mark | Марк
flight | полет
account | учетная запись
output | выход
last | последний
tour | тур
address | адрес
immediate | немедленное
reduction | сокращения
interview | интервью
assess | оценки
promote | поощрения
suitable | подходит
growing | растет
nod | кивок
reject | отклонить
while | в то время как
dream | сон
vote | голосование
divide | разделить
declare | объявить
handle | ручка
detailed | подробное
challenge | вызов
notice | уведомления
rain | дождь
destroy | уничтожить
mountain | горы
concentration | концентрация
limited | limited
finance | Финансы
pension | пенсионный
influence | влияние
afraid | боюсь
murder | убийство
neck | шея
weapon | оружие
hide | скрыть
offence | преступление
absence | отсутствие
error | ошибка
representative | представитель
enterprise | предприятие
criticism | критика
average | средняя
quick | быстрое
sufficient | достаточно
appointment | назначение
match | матч
transfer | передачи
acid | кислота
spring | весна
birth | рождения
ear | ухо
recognize | признать
recommend | рекомендуем
module | модуль
instruction | Инструкция
democratic | демократическая
park | парк
weather | погода
bottle | бутылка
address | адрес
bedroom | комната
kid | малыш
pleasure | удовольствие
realize | реализовать
assembly | Ассамблея
expensive | дорого
select | выберите
teaching | обучение
desire | желание
contact | контакт
implication | подтекст
combine | комбинат
temperature | температура
wave | волна
magazine | журнал
mental | психическое
used | используется
store | хранения
scientific | научный
thanks | спасибо
settlement | поселение
critical | критические
recognition | признание
touch | touch
consist | состоят
silence | молчание
expenditure | расходы
institute | институт
dress | платье
dangerous | опасно
familiar | знакомый
asset | актив
belong | принадлежат
educational | образовательные
sum | сумма
publication | публикации
block | блок
youth | молодежи
tape | лента
cover | крышка
fee | плата
program | программа
treaty | договора
unlikely | маловероятно
guest | гость
code | код
hill | холм
screen | экран
household | домохозяйства
sequence | последовательности
correct | правильный
female | женский
phase | фаза
crowd | толпа
welcome | добро пожаловать
metal | металл
human | человека
undertake | провести
cut | вырезать
sky | небо
brain | мозг
expert | эксперт
experiment | эксперимент
tiny | крошечные
perfect | идеальный
disappear | исчезают
initiative | инициатива
assumption | предположение
photograph | фотография
ministry | Министерство
congress | конгресс
transfer | передачи
reading | чтение
scientist | ученый
fast | быстрая
thin | тонкая
solicitor | юрисконсульт
secure | безопасный
plate | пластина
pool | бассейн
gold | золото
emphasis | акцент
recall | вспомнить
shout | крик
generate | генерировать
location | местоположение
display | дисплей
heat | тепла
gun | пистолет
shut | закрыть
journey | путешествие
imply | означает
violence | насилие
dry | сухой
historical | исторические
step | шаг
curriculum | учебный план
noise | шум
lunch | обед
fear | страх
succeed | успеха
fall | осень
bottom | дно
initial | первоначальный
theme | тема
characteristic | характеристика
empty | пустой
display | дисплей
combination | комбинация
interpretation | интерпретация
rely | полагаться
escape | побег
score | оценка
justice | справедливость
upper | верхняя
tooth | зуб
organise | организацию
cat | кошка
tool | инструмент
spot | место
bridge | мост
double | двухместный
direct | прямой
conclude | заключение
relative | Относительная
soldier | солдат
climb | восхождение
breath | дыхание
afford | позволить себе
urban | городской
nurse | медсестра
narrow | узкий
liberal | либеральная
coal | уголь
priority | приоритет
wild | дикие
revenue | выручка
membership | членство
grant | грант
approve | одобряю
tall | высокий
apparent | кажущаяся
faith | вера
fix | исправьте
slow | медленно
troop | войск
motion | движения
leading | ведущие
component | компонент
bloody | кровавый
literature | литература
conservative | консервативная
variation | вариации
remind | напомнить
inform | сообщите
alternative | альтернатива
mass | масса
busy | занят
chemical | химические
careful | осторожность
investigate | расследование
roll | рулон
instrument | инструмент
guide | руководство
criterion | критерий
pocket | карман
suggestion | предложение
entitle | право
tone | тон
attractive | привлекательный
wing | крыло
surprise | сюрприз
male | мужской
ring | кольцо
pub | паб
fruit | фрукты
passage | проход
illustrate | иллюстрации
pay | платить
ride | ездить
foundation | фонд
restaurant | Ресторан
vital | витал
alternative | альтернатива
burn | сжечь
map | карта
united | организации Объединенных
device | устройство
jump | прыжок
estimate | оценки
conduct | поведение
derive | извлечь
comment | комментарий
east | Восток
advise | советую
advance | аванс
motor | двигатель
satisfy | удовлетворить
winner | победитель
mistake | ошибка
incident | инцидент
focus | фокус
exercise | упражнение
representation | представительство
release | релиз
leaf | лист
border | границы
wash | мыть
prospect | перспектива
blow | удар
trip | поездки
observation | наблюдение
gather | собрать
ancient | древние
brief | краткий
gate | ворота
elderly | пожилые
persuade | убедить
overall | общее
rare | редкие
index | индекс
hand | рука
circle | круг
creation | создание
drawing | Рисунок
flow | поток
matter | вопрос
external | внешний
capable | способен
recover | восстановить
shot | выстрел
request | запрос
impression | впечатление
neighbour | сосед
theatre | театр
hurt | больно
mechanism | механизм
potential | потенциал
lean | lean
defendant | обвиняемый
atmosphere | атмосфера
slip | скольжения
chain | цепь
accompany | сопровождать
wonderful | замечательные
earn | заработать
enemy | враг
desk | стол
engineering | инжиниринг
panel | панели
distinction | различие
deputy | заместитель
discipline | дисциплины
strike | забастовка
married | женат
establishment | учреждение
fashion | мода
roof | крыша
milk | молоко
entire | всего
tear | слеза
secondary | среднее
finding | поиск
welfare | благосостояния
increased | увеличение
attach | прикрепить
typical | типичные
leadership | лидерство
walk | прогулка
negotiation | переговоров
clean | чистый
religion | религия
count | граф
grey | серый
first | первый
fuel | топливо
mine | мой
appeal | обращение
servant | слуга
liability | ответственность
constant | константа
hate | ненавижу
shoe | Чистка
expense | расходы
vast | огромные
soil | почвы
writing | писать
nose | нос
origin | происхождение
lord | лорд
rest | отдых
drive | привод
ticket | билет
editor | редактор
switch | переключатель
northern | Северной
significance | значение
channel | канал
convention | Конвенции
damage | ущерб
funny | смешно
bone | кости
severe | тяжелые
search | поиск
iron | Утюг
vision | видение
trend | тренд
revolution | революция
terrible | ужасно
knee | колено
dress | платье
steal | украсть
criminal | уголовного
signal | сигнал
notion | понятие
comparison | сравнение
academic | академическая
outcome | результат
lawyer | юрист
surround | объемный
explore | исследовать
achievement | достижения
odd | странно
expectation | ожидание
corporate | корпоративных
prisoner | узник
question | вопрос
southern | Южный
withdraw | отказаться
paint | краски
judge | судья
citizen | гражданин
permanent | постоянный
weak | слабый
separate | отдельный
plastic | пластик
connect | подключение
fundamental | фундаментальные
plane | самолет
height | высота
opening | открытие
lesson | урок
shock | шок
rail | железнодорожные
tenant | арендатор
owe | обязаны
middle | средний
minor | незначительные
negative | отрицательное
knock | стук
root | корень
pursue | преследовать
inner | внутренний
crucial | важно
occupy | занимают
independence | независимость
column | колонка
proceeding | исходя
female | женский
beauty | салон красоты
struggle | борьба
gap | разрыв
house | дом
database | базы данных
stretch | стрейч
stress | стресс
passenger | пассажир
boundary | граница
view | вид
manufacturer | производитель
sharp | sharp
formation | образование
queen | королева
waste | отходов
expand | расширить
contemporary | современные
politician | политик
back | назад
territory | территории
championship | чемпионата
exception | исключение
thick | толстой
inquiry | запрос
topic | тема
resident | резидент
transaction | транзакции
parish | приход
supporter | сторонник
massive | массивные
light | свет
unique | уникальный
challenge | вызов
inflation | инфляция
assistance | помощь
list | список
identity | личность
suit | костюм
parliamentary | парламентские
unknown | неизвестный
preparation | подготовка
elect | избрать
tie | галстук
cancer | рак
champion | Чемпион
exclude | исключить
review | обзор
licence | лицензии
breakfast | Завтрак
minority | меньшинства
appreciate | оценить
fan | вентилятор
chief | главный
accommodation | размещение
subsequent | последующие
democracy | демократии
brown | коричневый
taste | вкус
crown | корона
permit | разрешение
buyer | покупатель
gift | подарок
resolution | резолюция
angry | сердитый
metre | метр
wheel | колесо
break | перерыв
tank | танк
benefit | выгоды
engage | участвовать
alive | жив
complaint | жалоба
inch | дюйм
firm | фирма
abandon | отказаться
blame | винить
clean | чистый
quote | цитата
quantity | количество
rule | правило
guilty | виновным
prior | предварительного
round | круглый
eastern | Восточной
coat | пальто
involvement | участие
tension | напряжение
diet | диета
enormous | огромные
score | оценка
prize | приз
remaining | оставшиеся
glance | взгляд
dominate | доминировать
trust | доверие
interpret | интерпретации
land | земля
frame | кадр
extension | расширение
mix | микс
spokesman | представитель
friendly | friendly
acknowledge | признать
register | зарегистрироваться
regime | режим
fault | вина
dispute | спор
grass | трава
decline | спад
dismiss | уволить
delivery | Доставка
complain | жаловаться
conservative | консервативная
shift | сдвиг
port | порт
beach | пляж
string | строка
depth | глубина
unusual | необычные
travel | путешествия
pilot | пилот
obligation | обязательство
gene | гена
yellow | желтый
republic | Республика
shadow | тень
dear | уважаемые
analyse | анализ
average | средняя
phrase | фраза
long-term | долгосрочные
crew | экипаж
lucky | лаки
restore | восстановить
convince | убедить
coast | побережье
engineer | инженер
extensive | огромный
glad | рад
charity | благотворительность
oppose | против
defend | защищать
alter | изменить
warning | предупреждение
arrest | арест
framework | основы
approval | утверждение
bother | беспокоить
novel | Роман
accuse | обвинять
surprised | удивлен
currency | валюта
restrict | ограничения
possess | обладают
moral | моральные
protein | белка
distinguish | отличить
incorporate | включить
proceed | продолжить
assist | помощь
stress | стресс
justify | оправдать
behalf | имени
councillor | советник
setting | установка
command | команда
maintenance | техническое обслуживание
stair | лестница
poem | поэма
chest | грудь
secret | секрет
restriction | ограничение
efficient | эффективное
suspect | подозревать
hat | шляпа
tough | жесткая
willing | воля
healthy | здорового
focus | фокус
construct | строительство
mode | режим
saving | сохранение
comfortable | комфортабельные
camp | лагерь
trade | торговля
export | экспорт
wake | Звонок
partnership | партнерство
daily | ежедневно
profession | профессии
load | нагрузка
countryside | деревня
boot | загрузки
sudden | внезапно
implement | осуществление
reputation | репутация
print | печать
calculate | рассчитать
keen | Кин
guess | думаю
recommendation | рекомендации
autumn | осень
conventional | обычные
cope | справиться
constitute | составляют
poll | опрос
voluntary | добровольного
valuable | ценный
recovery | восстановление
cast | литье
premise | помещения
resolve | разрешить
solve | решить
plaintiff | Истец
critic | критик
agriculture | сельское хозяйство
ice | лед
constitution | Конституция
communist | Коммунистической
layer | слой
recession | рецессия
slight | легкое
dramatic | драматический
golden | золотой
temporary | временные
suit | костюм
arrival | прибытие
protest | протест
resistance | сопротивление
silent | молчание
presentation | презентация
soul | душа
self | самостоятельная
judgment | суд
feed | корма
muscle | мышцы
shareholder | акционер
opposite | напротив
pollution | загрязнения
wealth | богатство
video-taped | видео-пленку
kingdom | Королевство
bread | хлеб
perspective | перспективы
camera | камера
prince | принц
illness | болезни
cake | торт
meat | мясо
submit | представить
ideal | идеал
relax | расслабиться
penalty | казнь
purchase | покупки
tired | устал
beer | пиво
specify | укажите
monitor | монитор
electricity | электричество
bond | Бонд
statutory | законодательные
laboratory | лаборатория
federal | федеральный
captain | капитан
pour | залить
boss | босс
creature | существо
urge | призываю
locate | найти
being | будучи
struggle | борьба
lifespan | продолжительность жизни
flat | квартира
valley | долина
like | как
guard | храните
emergency | аварийный
dark | темные
bomb | бомба
dollar | доллар
efficiency | эффективность
mood | настроение
convert | конвертировать
possession | владение
marketing | маркетинг
please | пожалуйста
habit | привычка
round | круглый
purchase | покупки
sort | сортировка
outside | за пределами
expansion | расширение
competitive | конкурентные
co-operation | сотрудничество
acceptable | приемлемо
angle | угол
cook | повар
net | чистый
sensitive | чувствительные
ratio | коэффициент
kiss | поцелуй
amount | сумма
sleep | сон
finance | Финансы
fund | фонд
preserve | сохранить
wedding | свадьба
personality | личности
bishop | епископ
dependent | зависимых
landscape | пейзаж
pure | чистый
mirror | зеркало
lock | блокировки
symptom | симптом
promotion | продвижение
global | глобальной
tendency | тенденция
conservation | по сохранению
reply | ответ
estimate | оценки
qualification | квалификация
pack | обновления
governor | губернатор
expected | ожидалось
invest | инвестировать
cycle | цикл
alright | хорошо
philosophy | философия
gallery | галерея
sad | грустно
intervention | вмешательство
emotional | эмоциональная
advertising | реклама
regard | связи
dance | танец
cigarette | сигареты
predict | предсказать
adequate | адекватный
variable | переменная
net | чистый
retire | на пенсию
sugar | сахар
pale | бледный
frequency | частота
guy | парень
feature | функция
furniture | мебель
administrative | административные
wooden | деревянные
input | вход
phenomenon | явление
surprising | удивительно
jacket | куртка
actor | актер
kick | удар
producer | производитель
hearing | слух
chip | чип
equation | уравнение
certificate | сертификат
hello | Привет
remarkable | замечательные
alliance | Альянс
smoke | дым
awareness | осведомленность
throat | горло
discovery | открытие
festival | фестиваль
dance | танец
promise | обещание
rose | Роза
principal | основной
brilliant | блестящие
proposed | предлагаемые
coach | тренер
absolute | абсолютные
drama | Драма
recording | запись
bath | Ванна
celebrate | праздновать
substance | вещества
swing | качели
rapid | быстрое
rough | грубый
investor | инвестор
fire | огонь
rank | ранг
compete | конкурировать
sweet | сладкий
decline | спад
rent | аренды
dealer | дилер
bend | согните
solid | твердые
cloud | облако
level | уровень
enquiry | запрос
fight | бой
abuse | злоупотребление
golf | гольф
guitar | гитара
electronic | электронные
cottage | коттедж
scope | сфера применения
pause | пауза
mixture | смесь
emotion | эмоции
comprehensive | сравнительная
shirt | рубашка
allowance | резерв
retirement | выхода на пенсию
breach | нарушение
infection | инфекции
resist | сопротивляться
qualify | претендовать
sick | больной
near | рядом
researcher | исследователь
consent | согласие
written | письменные
literary | литературные
ill | плохо
wet | мокрые
lake | озеро
entrance | вход
peak | пик
sand | песок
breathe | дышать
cold | холодной
cheek | щеки
platform | платформа
interaction | взаимодействие
watch | смотреть
borrow | привлечь
birthday | день рождения
knife | нож
extreme | экстремальных
core | core
peasant | крестьянин
armed | вооруженных
permission | разрешение
supreme | Верховный
overcome | преодолеть
visual | визуальный
lad | парень
genuine | подлинная
personnel | персонал
judgement | решение
exciting | захватывающих
stream | поток
perception | восприятие
guarantee | гарантии
disaster | катастрофа
darkness | тьма
bid | заявку
sake | имя
organize | организовать
tourist | туристические
policeman | полицейский
castle | замок
figure | рис.
race | гонки
demonstration | демонстрация
anger | гнев
clock | часы
hero | герой
expose | разоблачение
custom | пользовательские
maximum | максимальная
wish | желание
earning | зарабатывать
priest | священник
resign | уйти в отставку
store | хранения
widespread | широкое
comprise | включают
chamber | палата
acquisition | приобретение
involved | участие
confident | уверенно
circuit | цепи
radical | радикальные
detect | обнаружить
stupid | глупый
grand | grand
consumption | потребление
hold | удерживайте
zone | зона
mean | имею в виду
rush | rush
numerous | многочисленные
sink | раковина
classical | классический
distinct | отличие
mad | с ума
honour | честь
statistics | статистика
false | false
square | площадь
differ | отличаются
disk | диск
survival | выживание
proud | горд
tower | башня
deposit | депозит
pace | ПАСЕ
compensation | компенсация
adviser | советник
consultant | консультант
drag | перетащите
advanced | расширенные
landlord | хозяин
delay | задержка
green | зеленый
car | автомобиль
holder | держатель
secret | секрет
edition | издание
occupation | оккупация
agricultural | сельскохозяйственных
intelligence | интеллект
empire | империя
negotiate | переговоры
host | хост
relative | Относительная
mass | масса
helpful | полезно
fellow | парень
sweep | развертки
poet | поэт
journalist | журналист
defeat | поражение
tight | плотно
indication | индикация
dry | сухой
cricket | крикет
whisper | шепот
routine | обычных
print | печать
anxiety | тревога
witness | свидетель
mill | мельница
gentle | нежный
curtain | занавес
mission | миссия
supplier | поставщик
assure | уверяю
poverty | бедность
snow | снег
prayer | молитва
pipe | трубы
deserve | заслуживают
shift | сдвиг
split | сплит
consistent | последовательная
carpet | ковер
ownership | собственности
joke | шутка
workshop | семинар
salt | соль
symbol | символ
slide | слайд
cross | крест
anxious | встревоженные
tale | сказка
preference | предпочтение
mere | подробнее
behave | вести себя
gain | прибыль
nervous | нервная
guide | руководство
remark | Примечание
pleased | доволен
province | провинция
steel | сталь
practise | практиковать
flow | поток
holy | Святой
dose | доза
alcohol | алкоголь
guidance | руководство
climate | климат
enhance | повышения
waste | отходов
smooth | гладкая
dominant | доминанта
conscious | сознательное
formula | формула
tail | хвост
electric | Электрический
sheep | овцы
medicine | медицина
strategic | стратегический
disabled | инвалидов
smell | запах
operator | оператор
mount | горе
advance | аванс
remote | дистанционного
measurement | измерения
favour | пользу
architecture | архитектура
worth | стоит
tie | галстук
barrier | барьер
practitioner | практик
outstanding | выдающиеся
enthusiasm | энтузиазм
theoretical | теоретические
implementation | осуществление
worried | беспокоит
pitch | шаг
drop | падение
phone | телефон
shape | форма
clinical | клинических
lane | Лейн
apple | apple
catalogue | каталог
tip | Совет
publisher | издатель
opponent | соперник
live | жить
burden | бремя
tackle | решения
historian | историк
bury | хоронить
stomach | желудок
percentage | процент
evaluation | оценки
outline | набросок
talent | талант
lend | одолжите
silver | серебро
pack | обновления
fun | весело
democrat | демократ
fortune | Фортуна
storage | хранение
professional | профессиональные
reserve | резерв
interval | интервал
dimension | измерение
honest | честный
awful | ужасно
manufacture | производство
confusion | путаница
pink | розовый
impressive | впечатляет
satisfaction | удовлетворение
visible | видимые
vessel | судно
stand | стенд
curve | кривая
pot | горшок
replacement | замена
accurate | точный
mortgage | Ипотека
salary | зарплата
impress | произвести впечатление
constitutional | Конституционного
emphasise | подчеркнуть
developing | развивающихся
proof | доказательство
dish | блюдо
interview | интервью
distant | далекий
lower | Нижняя
favourite | любимый
tear | слеза
fixed | фиксированной
luck | удачи
count | граф
precise | точный
determination | определение
bite | укус
dear | уважаемые
consultation | консультации
range | диапазон
residential | жилой
conduct | поведение
capture | захват
cheque | чек
economics | экономика
sustain | поддерживать
silly | глупо
merchant | купец
lecture | лекция
musical | музыкальные
leisure | развлечения
check | проверьте
cheese | сыр
lift | Лифт
participate | участие
fabric | ткани
distribute | распространять
lover | любовник
childhood | детство
cool | круто
ban | запрет
supposed | должен
mouse | мышь
strain | штамм
specialist | специалист
consult | консультации
minimum | минимальный
participant | участник
monetary | денежная
confuse | путать
dare | смею
smoke | дым
movie | кино
seed | семя
cease | прекратить
journal | журнал
shopping | торговый
equivalent | эквивалент
palace | дворец
exceed | превышать
isolated | изолированный
poetry | поэзия
perceive | воспринимать
lack | недостаток
strengthen | укрепить
snap | snap
spite | несмотря на
conviction | убеждение
corridor | коридор
ward | Уорд
profile | профиль
fat | жир
comfort | комфорт
bathroom | ванная комната
shell | shell
reward | награды
vegetable | растительные
imagination | воображение
junior | junior
unemployed | безработных
mystery | тайна
pose | поза
violent | насилия
march | марта
found | нашел
dig | копать
dirty | грязные
straight | сейчас
psychological | психологические
grab | схватить
pleasant | приятные
surgery | хирургия
inevitable | неизбежное
transform | преобразование
bell | колокольчик
announcement | объявление
draft | проект
unity | единство
airport | аэропорт
upset | расстроен
pretend | притворяться
plant | завод
known | известный
admission | прием
tissue | ткани
magistrate | магистрат
joy | радость
free | бесплатно
pretty | довольно
operating | операционные
headquarters | штаб-квартира
grateful | благодарен
classroom | класс
turnover | оборот
project | проект
shrug | пожав плечами
sensible | разумный
limitation | ограничение
specialist | специалист
tongue | язык
refugee | беженцев
delay | задержка
dream | сон
composition | состав
ceiling | потолок
highlight | выделите
stick | stick
favourite | любимый
tap | нажмите
universe | Вселенная
request | запрос
label | этикетка
confine | ограничить
scream | крик
rid | избавиться
acceptance | признание
detective | детектив
sail | парус
adjust | Настройка
designer | дизайнер
running | запуск
summit | саммит
participation | участие
weakness | слабость
block | блок
so-called | так называемые
adapt | адаптировать
absorb | поглощения
encounter | встреча
defeat | поражение
excitement | волнение
brick | кирпич
blind | слепой
wire | провода
crop | урожай
square | площадь
transition | переход
protest | протест
roll | рулон
stop | стоп
assistant | помощник
deaf | глухие
constituency | избирательный округ
continuous | непрерывный
concert | концерт
breast | грудь
extraordinary | Чрезвычайный
squad | состав
wonder | чудо
cream | крем
tennis | теннис
communicate | общаться
pride | гордость
bowl | чаша
file | файл
expertise | экспертиза
govern | управлять
leather | кожа
observer | наблюдатель
margin | маржа
uncertainty | неопределенность
reinforce | укрепить
ideal | идеал
injure | ранить
holding | Холдинг
universal | универсальный
evident | очевидно
dust | пыль
overseas | за рубежом
desperate | отчаянный
swim | плавать
occasional | случайные
trouser | брюк
register | зарегистрироваться
album | альбом
guideline | Руководящий принцип
disturb | беспокоить
amendment | поправка
architect | архитектор
objection | возражение
chart | график
cattle | крупный рогатый скот
doubt | сомнения
react | реагировать
consciousness | сознание
right | право
tin | олово
tube | труба
fulfil | выполнять
coin | монета
frighten | пугать
grammar | грамматика
diary | дневник
flesh | плоть
summary | резюме
infant | детская
stir | перемешать
storm | шторм
mail | почта
rugby | регби
virtue | добродетель
specimen | образец
psychology | психология
paint | краски
constraint | ограничение
trace | след
privilege | привилегия
completion | завершение
progress | прогресс
grade | содержание
exploit | использовать
import | импорт
potato | картофель
repair | удалить
passion | страсть
seize | захватить
underlying | базового
heaven | небо
nerve | нервные
park | парк
collapse | коллапс
win | победа
printer | принтер
coalition | коалиции
button | кнопка
pray | молиться
ultimate | ultimate
venture | предприятие
timber | древесины
companion | спутник
horror | ужас
gesture | жест
moon | луна
remark | Примечание
clever | умный
van | Ван
raw | raw
glance | взгляд
broken | сломанные
jury | жюри
gaze | взгляд
burst | взрыв
charter | Устав
feminist | феминистка
discourse | дискурс
reflection | отражение
carbon | углерода
sophisticated | сложные
ban | запрет
taxation | налогообложение
prosecution | преследование
asleep | спит
aids | СПИД
publicity | гласность
departure | отъезд
welcome | добро пожаловать
reception | прием
cousin | кузен
relieve | сбросить
linguistic | лингвистический
vat | НДС
forward | вперед
blue | синий
multiple | несколько
pass | пройти
outer | космического
vulnerable | уязвимых
patient | пациент
evolution | эволюция
allocate | выделить
creative | творческий
just | просто
judicial | судебной
risk | риск
ideology | идеология
smell | запах
agenda | повестка дня
transport | транспорт
illegal | незаконное
chicken | курица
plain | обычная
innovation | инновации
opera | Опера
lock | блокировки
grin | улыбка
shelf | шельф
pole | Полюс
punishment | наказание
strict | строгий
wave | волна
inside | внутри
carriage | перевозки
fit | fit
conversion | преобразования
hurry | спешите
essay | эссе
integration | интеграция
resignation | отставка
treasury | казначейства
traveller | путешественник
chocolate | шоколад
assault | нападение
schedule | расписание
twin | twin
format | формат
murder | убийство
sigh | вздох
seller | продавец
lease | лизинг
bitter | горький
double | двухместный
ally | союзник
stake | доля
processing | обработки
informal | неофициальные
flexible | гибкий
cap | cap
stable | стабильный
sympathy | сочувствие
tunnel | туннель
pen | перо
instal | Room
suspend | приостановить
blow | удар
wander | бродить
disappoint | разочаровал
wipe | протрите
folk | народные
attraction | привлечение
disc | диск
inspire | вдохновлять
machinery | Машиностроение
undergo | пройти
inspector | инспектор
wise | мудрый
balance | баланс
purchaser | покупатель
resort | курорт
pop | поп
organ | орган
ease | легкость
friendship | дружба
deficit | дефицит
dear | уважаемые
convey | передать
reserve | резерв
planet | Планета
frequent | частые
loose | loose
intense | интенсивный
retail | розничной
wind | ветер
lost | потерял
grain | зерно
particle | частиц
destruction | удаление
witness | свидетель
pit | яма
registration | регистрации
conception | концепция
steady | устойчивый
rival | соперник
steam | пара
back | назад
chancellor | канцлер
crash | crash
belt | ремень
logic | логика
premium | премиум
confront | противостоять
precede | предшествовать
experimental | экспериментальный
alarm | сигнализация
rational | rational
incentive | стимул
bench | скамейки
wrap | обертывание
inadequate | неадекватные
ambition | честолюбие
fate | судьба
vendor | поставщик
stranger | незнакомец
spiritual | духовной
increasing | увеличение
anticipate | предвидеть
logical | логические
fibre | волокна
attribute | атрибут
sense | смысл
black | черный
petrol | бензин
maker | чайник
generous | щедрые
allocation | распределение
depression | депрессия
declaration | декларации
spot | место
modest | скромный
bottom | дно
dividend | дивидендов
devote | посвятить
condemn | осуждать
integrate | интеграции
pile | сваи
identification | идентификация
acute | острая
directive | Директива
bet | ставка
modify | изменить
bare | голые
swear | клянусь
final | финал
valid | действительный
mortality | смертность
medium | средний
silk | шелк
funeral | похороны
depending | в зависимости
cow | корова
correspond | соответствуют
cite | цитировать
classic | классический
inspection | инспекции
calculation | расчет
rubbish | мусор
minimum | минимальный
hypothesis | гипотеза
youngster | юнец
slope | склон
patch | патч
invitation | приглашение
ethnic | этнических
federation | Федерации
duke | герцог
closure | закрытие
dictionary | словарь
withdrawal | вывод
automatic | автоматическая
liable | ответственность
cry | крик
slow | медленно
borough | borough
well | хорошо
suspicion | подозрение
portrait | портрет
local | местные
jew | еврей
fragment | фрагмент
revolutionary | революционные
evaluate | оценить
competitor | конкурент
sole | Единоличный
reliable | надежный
weigh | весят
medieval | средневековый
clinic | клиника
shine | обуви
knit | вязать
complexity | сложность
remedy | средство
fence | забор
bike | велосипед
freeze | замораживание
eliminate | исключить
interior | интерьер
intellectual | интеллектуальной
established | создан
voter | избирателей
garage | гараж
era | эра
pregnant | беременных
plot | участок
greet | Приветствуйте
electrical | электрические
lie | ложь
disorder | расстройства
excuse | извините
socialist | социалистических
cancel | отмена
harm | вреда
excess | превышение
exact | точное
oblige | обязать
accountant | бухгалтер
mutual | взаимного
fat | жир
volunteer | волонтер
laughter | смех
trick | обмануть
load | нагрузка
disposal | утилизация
taxi | такси
murmur | шепот
tonne | тонну
spell | заклинание
clerk | клерк
curious | любопытно
satisfactory | удовлетворительное
identical | идентичны
applicant | заявитель
removal | удаления
processor | процессор
cotton | хлопок
reverse | реверс
hesitate | колеблясь
professor | профессор
admire | восхищаюсь
electoral | избирательных
delight | восторг
urgent | срочно
prompt | приглашение
mate | помощник
exposure | экспозиции
server | сервер
distinctive | отличительные
marginal | предельные
structural | структурные
rope | Канат
miner | Шахтер
entertainment | развлечения
acre | акр
pig | свинья
encouraging | поощрения
guarantee | гарантии
gear | снасти
anniversary | юбилей
ceremony | церемония
rub | rub
monopoly | монополия
left | слева
flee | бежать
yield | доходность
discount | скидка
above | выше
uncle | дядя
audit | аудит
advertisement | реклама
explosion | взрыв
contrary | отличие
tribunal | Трибунал
swallow | ласточка
fun | весело
rat | крыса
cloth | ткань
cable | кабель
interrupt | прерывания
crash | crash
flame | пламя
controversy | споры
rabbit | кролик
everyday | повседневной
allegation | обвинение
strip | полосы
stability | стабильность
tide | прилив
illustration | иллюстрации
insect | насекомое
correspondent | корреспондент
devise | разработки
determined | определена
brush | кисть
adjustment | настройки
controversial | спорный
organic | органических
escape | побег
interface | интерфейс
historic | исторический
collapse | коллапс
temple | храм
shade | тень
craft | ремесло
nursery | питомник
piano | фортепиано
desirable | желательно
assurance | гарантии
jurisdiction | юрисдикции
advertise | рекламировать
bay | bay
specification | спецификация
disability | инвалидности
presidential | президентских
arrest | арест
unexpected | неожиданное
switch | переключатель
penny | Пенни
respect | уважение
celebration | праздник
gross | брутто
aid | помощь
superb | превосходно
process | процесс
innocent | невинный
leap | прыжок
colony | колонии
wound | рана
hardware | оборудование
satellite | Спутниковое
float | float
bible | Библия
statistical | статистические
marked | помеченные
hire | Прокат
cathedral | собор
motive | мотив
correct | правильный
gastric | желудка
raid | raid
comply | соответствие
accommodate | разместить
mutter | бормочу : 
induce | вызывать
trap | ловушка
invasion | вторжение
humour | юмор
bulk | навалом
commission | комиссия
translate | перевести
rhythm | ритм
emission | эмиссии
collective | коллективные
transformation | трансформации
battery | батареи
stimulus | стимул
naked | голый
white | белый
menu | меню
toilet | Туалет
butter | сливочное масло
surprise | сюрприз
needle | игла
effectiveness | эффективность
accordance | соответствии
molecule | молекула
fiction | фантастика
learning | обучение
statute | статут
reluctant | неохотно
overlook | игнорировать
junction | выезд
necessity | необходимость
nearby | поблизости
experienced | опытные
lorry | грузовик
exclusive | эксклюзивные
graphics | графика
stimulate | стимулировать
warmth | тепло
therapy | терапия
convenient | удобно
cinema | кино
domain | домен
tournament | турнир
doctrine | доктрина
sheer | sheer
proposition | предложение
grip | сцепление
widow | вдова
discrimination | дискриминации
ruling | постановление
fit | fit
myth | миф
episode | эпизод
drift | дрейф
assert | утверждают
terrace | Терраса
uncertain | неопределенное
twist | твист
insight | insight
undermine | подорвать
tragedy | трагедия
enforce | исполнение
criticise | критиковать
march | марта
leaflet | листовка
fellow | парень
object | объект
pond | пруд
adventure | Приключения
diplomatic | дипломатические
mixed | смешанная
rebel | rebel
equity | капитал
magnificent | великолепный
loyalty | лояльность
tremendous | огромные
airline | авиакомпании
shore | берег
restoration | восстановление
render | рендер
institutional | институциональные
emphasize | подчеркнуть
mess | беспорядок
commander | Командор
straightforward | простой
singer | певица
squeeze | сожмите
full-time | full-time
breed | породы
successor | преемник
triumph | триумф
heading | заголовок
mathematics | математика
laugh | смеяться
clue | ключ
still | еще
ease | легкость
biological | биологических
forgive | прости
trustee | доверенное лицо
photo | фото
fraction | фракция
chase | погоня
mud | грязи
pensioner | пенсионер
functional | функциональные
copy | копировать
await | ждут
coverage | охват
wildlife | дикой природы
indicator | индикатор
hierarchy | иерархии
evolve | развиваться
mechanical | механические
expert | эксперт
creditor | кредитор
capitalist | капиталистической
essence | суть
compose | сочинять
gaze | взгляд
seminar | семинар
target | цель
label | этикетка
fig | рис.
continent | континент
chap | chap
flexibility | гибкость
verse | стих
minute | минуту
whisky | виски
equivalent | эквивалент
recruit | рекрут
echo | эхо
unfair | несправедливо
launch | запустить
cupboard | шкаф
bush | Буш
shortage | дефицит
prominent | видное
merger | слияние
command | команда
subtle | тонкие
capital | капитал
gang | банда
fish | рыбы
unhappy | несчастная
lifetime | жизни
elite | элита
refusal | отказ
finish | закончить
aggressive | агрессивный
superior | улучшенный
landing | посадки
exchange | обмен
debate | дискуссии
educate | воспитывать
separation | разделение
productivity | производительность
initiate | начать
probability | вероятность
virus | вирус
reporter | репортер
fool | дурак
pop | поп
capitalism | капитализм
painful | болезненные
complex | комплекс
rumour | слух
imperial | Империал
justification | обоснование
availability | доступность
spectacular | эффектные
remain | остаются
ocean | океан
cliff | утес
sociology | социология
missile | ракета
situate | стоящий
artificial | искусственный
apartment | квартира
provoke | спровоцировать
oral | устные
maximum | максимальная
angel | Ангел
spare | запасные
shame | стыд
intelligent | интеллектуальные
discretion | усмотрению
businessman | бизнесмен
explicit | явного
book | книги
uniform | униформа
push | нажмите
counter | счетчик
subject | тема
objective | цель
hungry | голодные
clothing | одежда
ride | ездить
romantic | романтический
attendance | посещаемость
part-time | часть времени
trace | след
backing | подложки
sensation | сенсация
carrier | перевозчик
interest | интерес
classification | классификация
classic | классический
beg | прошу
appendix | приложение
doorway | проем
density | плотность
working-class | Рабочий класс
legislative | законодательные
hint | подсказка
shower | Душ
current | ток
succession | правопреемство
nasty | противный
duration | продолжительность
desert | пустыня
receipt | получение
native | родной
chapel | часовня
amazing | удивительный
fleet | флот
comparable | сопоставимые
oxygen | кислород
installation | установка
developer | разработчик
disadvantage | недостаток
recipe | рецепт
crystal | кристалл
modification | модификации
schedule | расписание
midnight | полночь
successive | последовательных
loud | громко
value | значение
physics | физика
truck | грузовик
stroke | инсульт
kiss | поцелуй
envelope | конверт
speculation | спекуляции
canal | канал
unionist | профсоюзный активист
directory | каталог
receiver | приемник
isolation | изоляции
fade | затемнение
chemistry | химия
unnecessary | ненужные
hit | хит
defender | защитник
stance | позиция
sin | грех
realistic | реалистичные
socialist | социалистических
subsidy | субсидия
content | содержание
toy | игрушка
darling | дорогая
decent | достойного
liberty | свобода
skirt | юбка
coordinate | координат
tactic | тактика
influential | влиятельные
import | импорт
accent | акцент
compound | соединение
bastard | ублюдок
ingredient | ингредиент
dull | скучно
cater | удовлетворения
scholar | ученый
faint | слабый
ghost | призрак
sculpture | скульптура
ridiculous | смешно
diagnosis | диагностика
delegate | делегат
neat | аккуратный
kit | комплект
lion | Лев
dialogue | диалог
repair | удалить
tray | лоток
fantasy | фантазия
leave | оставьте
export | экспорт
lamp | лампы
allege | утверждают
pavement | мостовой
brand | бренд
constable | констебль
compromise | компромисс
flag | флаг
filter | фильтр
reign | царствование
execute | выполнить
pity | жалость
merit | заслуги
diagram | схема
wool | шерсть
organism | организм
elegant | элегантный
red | красный
undertaking | предприятия
lesser | меньшее
reach | достижения
marvellous | дивно
improved | улучшение
entity | лица
rape | изнасилование
secure | безопасный
descend | спускаться
peer | peer
excuse | извините
genetic | генетические
fold | раз
portfolio | портфель
consensus | консенсус
thesis | диссертации
shop | магазин
nest | гнездо
frown | хмуриться
builder | строитель
administer | администрирование
tip | Совет
lung | легких
delegation | делегация
outside | за пределами
heating | Отопление
instinct | инстинкт
teenager | подросток
lonely | одинокий
residence | проживание
radiation | радиация
extract | экстракт
concession | концессии
autonomy | автономии
norm | норма
musician | музыкант
graduate | выпускник
glory | слава
bear | медведь
persist | сохраняются
rescue | спасение
equip | оборудовать
partial | частичное
capability | возможности
worry | беспокоиться
liberation | освобождение
hunt | охота
heel | каблук
contract | контракт
update | обновления
assign | назначение
spring | весна
single | одноместный
commons | commons
weekly | еженедельно
stretch | стрейч
pregnancy | беременность
spectrum | спектр
interfere | вмешиваться
suicide | самоубийство
panic | паника
invent | изобретать
intensive | интенсивный
damp | влажные
giant | гигант
casual | случайные
sphere | сфера
precious | драгоценные
sword | меч
envisage | предусмотреть
bean | Боб
time | время
crazy | сумасшедший
changing | изменение
primary | первичной
concede | уступить
unite | объединить
instruct | поручить
insert | вставить
exhibit | экспонат
brave | храбрый
tutor | преподаватель
tune | мелодия
debut | дебют
continued | продолжение
bid | заявку
incidence | заболеваемость
cafe | кафе
regret | сожаление
killer | убийца
delicate | нежный
subsidiary | дочернего
gender | пола
entertain | отдыхать
cling | цепляешься
vertical | вертикальная
fetch | fetch
strip | полосы
plead | судиться
duck | утка
breed | породы
assistant | помощник
pint | пинта
abolish | отменить
translation | перевод
princess | принцесса
line | линия
excessive | чрезмерное
digital | цифровой
steep | крутой
jet | водный
grave | могила
exceptional | исключительные
boost | увеличить
random | случайные
correlation | корреляция
outline | набросок
intervene | вмешиваться
packet | пакет
motivation | мотивация
harsh | суровый
spell | заклинание
spread | распространение
draw | рисовать
concrete | бетон
complicated | сложный
alleged | якобы
redundancy | избыточность
progressive | прогрессивный
intensity | интенсивность
crack | трещина
fly | летать
fancy | фантазия
waiting | ожидание
scandal | скандал
resemble | напоминают
parameter | параметр
fierce | свирепый
tropical | тропических
colour | цвет
engagement | взаимодействие
contest | конкурс
edit | редактировать
courage | мужество
hip | хип
delighted | в восторге
sponsor | спонсор
carer | уходу
crack | трещина
occupational | профессиональных
trainer | тренер
remainder | остаток
related | связанных с
inherit | наследовать
resume | резюме
assignment | назначение
conceal | скрыть
disclose | раскрывать
working | Рабочая
mild | мягкая
chronic | хронические
splendid | великолепные
function | функция
rider | всадник
clay | глина
conceive | задумайте
terminal | терминал
accuracy | точность
coup | переворот
ambulance | скорая помощь
living | жизни
offender | преступник
similarity | сходство
orchestra | оркестр
brush | кисть
systematic | систематический
striker | нападающий
guard | храните
casualty | ранениях
painter | художник
opt | отказаться
handsome | красивый
banking | банковской
sensitivity | чувствительность
navy | флот
fascinating | увлекательные
disappointment | разочарование
auditor | аудитор
hostility | враждебность
spending | расходы
compulsory | обязательное
photographer | фотограф
neighbourhood | добрососедство
ideological | идеологические
pardon | помилование
double | двухместный
criticize | критиковать
supervision | надзор
guilt | чувство вины
deck | палуба
payable | Кредиторская задолженность
execution | исполнение
suite | люкс
elected | избран
moral | моральные
collector | коллекционер
questionnaire | анкета
flavour | вкус
couple | пара
faculty | факультет
tour | тур
basket | корзина
mention | упоминание
kick | удар
horizon | горизонт
drain | слива
happiness | счастье
fighter | истребитель
estimated | по оценкам
copper | медь
legend | легенда
relevance | релевантность
decorate | украсить
continental | Континентальный
ship | корабль
operational | оперативные
incur | несут
parallel | параллельный
divorce | развод
opposed | против
equilibrium | равновесие
trader | трейдер
can | может
juice | сок
forum | форум
spin | спин
research | исследования
hostile | Враждебна
technological | технологических
nightmare | кошмар
medal | медаль
diamond | алмаз
speed | скорость
peaceful | мирное
accounting | бухгалтерского учета
scatter | рассеять
monster | монстр
horrible | ужасно
nonsense | ерунда
chaos | хаос
accessible | доступны
humanity | человечество
frustration | разочарование
chin | подбородок
bureau | бюро
advocate | адвокат
polytechnic | политехнический
inhabitant | житель
evil | зло
slave | раб
reservation | бронирование
slam | slam
handle | ручка
provincial | провинциальный
fishing | рыбалка
facilitate | способствовать
yield | доходность
elbow | локоть
bye | до свидания
warm | теплый
sleeve | рукав
exploration | разведка
creep | ползучести
adjacent | смежные
theft | кражи
round | круглый
grace | благодать
predecessor | предшественник
supermarket | супермаркет
smart | smart
sergeant | сержант
regulate | регулировать
clash | столкновение
assemble | собрать
arrow | стрелка
giant | гигант
waiting | ожидание
tap | нажмите
shit | дерьмо
sandwich | сэндвич
vanish | исчезнуть
commerce | коммерция
pursuit | погоня
post-war | после войны
will | будет
waste | отходов
collar | воротник
socialism | социализм
skill | мастерство
rice | рис
exclusion | исключения
transmission | передачи
forthcoming | предстоящие
appointed | назначен
geographical | географические
fist | fist
abstract | Аннотация
embrace | объятия
dynamic | динамический
drawer | ящик
dismissal | увольнение
magic | магия
endless | бесконечные
definite | определенный
affection | любовь
dawn | рассвет
principal | основной
bloke | парень
organiser | Органайзер
trap | ловушка
communist | Коммунистической
competence | компетенции
complicate | усложнять
neutral | нейтральный
commonwealth | Содружество
breakdown | разбивка
combined | в сочетании
candle | свеча
venue | место проведения
supper | ужин
analyst | аналитик
vague | смутные
marine | морской
pause | пауза
notable | заметным
counterpart | коллега
lively | живой
script | скрипт
sue | Сью
legitimate | законных
geography | география
reproduce | воспроизвести
moving | перемещение
lamb | Агнец
gay | gay
contemplate | созерцать
terror | террор
stable | стабильный
founder | основатель
utility | утилиты
signal | сигнал
shelter | приют
poster | плакат
mature | зрелых
cooking | приготовление пищи
head | голова
wealthy | богатые
confess | признаться
age | возраст
miracle | чудо
magic | магия
jaw | челюсти
pan | Пан
coloured | цветные
tent | шатер
telephone | телефон
reduced | снижается
tumour | опухоли
super | супер
funding | финансирование
dump | дамп
stitch | строчка
shared | общий
ladder | лестница
keeper | keeper
endorse | одобрить
smash | smash
shield | щит
heat | тепла
surgeon | хирург
centre | центр
orange | оранжевый
explode | взорваться
comedy | комедия
classify | классифицировать
artistic | художественных
ruler | правитель
biscuit | бисквит
workstation | Рабочая станция
prey | добычу
manual | руководство
cure | вылечить
overall | общее
tighten | затяните
tax | налог
pope | папа
manufacturing | производство
adult | взрослый
rush | rush
blanket | одеяло
republican | республиканского
referendum | референдум
palm | palm
mix | микс
devil | дьявол
adoption | принятие
workforce | рабочей силы
segment | сегмент
contractor | подрядчик
portion | часть
deposit | депозит
cook | повар
prediction | предсказание
oven | печь
matrix | матрица
liver | печени
fraud | мошенничество
beam | луч
signature | подпись
limb | конечности
verdict | вердикт
container | контейнер
aunt | тетя
dock | док
submission | представление
arm | рука
odd | странно
certainty | уверенность
boring | скучно
electron | электрон
drum | барабан
wisdom | мудрость
antibody | антитела
unlike | в отличие от
terrorist | террорист
post | должность
circulation | обращения
alteration | изменения
fluid | жидкости
ambitious | амбициозный
riot | бунт
petition | прошение
fox | Фокс
recruitment | вербовка
well-known | известный
top | топ
service | услуги
flood | наводнение
taste | вкус
memorial | Мемориал
helicopter | вертолет
correspondence | переписка
beef | говядина
lighting | освещение
harbour | гавань
empirical | эмпирические
shallow | мелководных
seal | печать
decrease | уменьшение
constituent | учредительными
exam | экзамен
toe | палец
reward | награды
thrust | упорная
bureaucracy | бюрократия
wrist | запястье
nut | гайка
plain | обычная
magnetic | магнитные
evil | зло
widen | расширить
hazard | опасность
dispose | распоряжаться
dealing | дело
absent | отсутствует
reassure | успокоить
model | модель
inn | inn
initial | первоначальный
suspension | подвеска
respondent | респондент
over | над
naval | военно-морской
monthly | ежемесячно
log | журнал
advisory | Консультативный
fitness | фитнес
blank | пустой
indirect | косвенные
tile | плитка
rally | ралли
economist | экономист
vein | Вену
strand | strand
disturbance | помехи
stuff | материал
coming | пришествие
cab | такси
grandfather | дед
flash | flash
destination | назначения
regiment | полка
closed | закрыт
boom | бум
handful | горсть
encouragement | поощрения
awkward | неловко
required | требуется
flood | наводнение
defect | дефект
surplus | профицит
champagne | шампанское
liquid | жидкость
shed | пролить
welcome | добро пожаловать
rejection | отказ
discipline | дисциплины
halt | остановить
electronics | Электроника
administrator | администратор
sentence | приговор
contradiction | противоречие
nail | гвоздь
senior | старший
lacking | не хватает
colonial | колониальный
primitive | примитивные
lap | на коленях
commodity | товар
planned | планируемые
intellectual | интеллектуальной
imprisonment | заключение
coincide | совпадают
sympathetic | отзывчивая
atom | атом
tempt | соблазнить
sanction | санкция
praise | хвала
favourable | благоприятные
dissolve | растворить
surrounding | окружающих
soup | суп
encounter | встреча
abortion | аборт
grasp | понять
custody | хранение
composer | композитор
charm | очарование
short-term | краткосрочные
metropolitan | митрополит
waist | талия
equality | равенство
tribute | дань
bearing | подшипник
auction | аукцион
standing | стоя
manufacture | производство
horn | Рог
barn | амбар
mayor | мэр
emperor | император
rescue | спасение
integrated | интегрированный
conscience | совесть
commence | начать
grandmother | бабушка
discharge | разряд
profound | глубокое
takeover | присоединении
nationalist | националист
effect | эффект
dolphin | Дельфин
fortnight | две недели
elephant | слон
seal | печать
spoil | испортить
plea | мольба
breeze | Бриз
prevention | профилактика
mineral | минеральные
runner | бегун
pin | контактный
integrity | целостность
quid | услуга за услугу
owl | сова
rigid | жесткая
orange | оранжевый
draft | проект
hedge | хедж
formulate | сформулировать
associated | связанные
position | должность
thief | вор
tomato | помидор
exhaust | выхлоп
eagle | Орел
specified | указанных
resulting | результате
blade | лезвие
peculiar | своеобразный
killing | убийство
desktop | desktop
bowel | кишечника
long | долго
ugly | уродливый
expedition | экспедиция
saint | Сен
variable | переменная
supplement | возможно (дополнительно)
stamp | штамп
slide | слайд
faction | фракция
enthusiastic | восторженные
enquire | вопрошать
brass | латунь
inequality | неравенства
eager | нетерпеливый
bold | полужирный
neglect | пренебрежение
saying | говоря
ridge | Ридж
earl | Эрл
yacht | яхты
suck | suck
missing | отсутствующие
extended | расширенный
valuation | оценки
delight | восторг
beat | бить
worship | поклонение
fossil | ископаемое
diminish | уменьшить
taxpayer | налогоплательщик
corruption | коррупция
honour | честь
depict | изображать
pencil | карандаш
drown | утонуть
stem | стволовые
lump | шишка
applicable | компьютерной информации применяемыми
rate | ставка
mobility | мобильность
immense | огромные
goodness | благость
price | цена
preliminary | предварительные
graph | график
referee | рефери
calm | спокойствие
omit | пропустить
excite | excite
dreadful | ужасно
cave | пещера
revelation | откровение
grief | горе
erect | выпрямившись
tuck | заправь
meantime | тем временем
barrel | баррель
lawn | лужайка
hut | хижина
swing | качели
subject | тема
ruin | руины
slice | ломтик
transmit | передачи
thigh | бедро
dedicate | посвящаю
mistake | ошибка
corresponding | связанных
sound | звук
nurse | медсестра
discharge | разряд
comparative | сравнительные
cluster | кластер
propose | предлагаем
obstacle | препятствие
motorway | автострада
heritage | наследие
counselling | консультирование
breeding | разведение
characteristic | характеристика
bucket | ведро
migration | миграции
campaign | кампания
ritual | ритуал
originate | происходят
hunting | охота
crude | сырой
protocol | протокол
prejudice | ущерба
inspiration | вдохновение
dioxide | диоксид
chemical | химические
uncomfortable | неудобно
worthy | достоин
inspect | проверить
summon | вызвать
parallel | параллельный
outlet | розетки
okay | о'кей
collaboration | сотрудничество
booking | бронирование
salad | салат
productive | продуктивные
charming | очаровательная
polish | польский
oak | дуб
access | доступ
tourism | туризм
cruel | жестокое
diversity | разнообразие
accused | обвинил
supplement | возможно (дополнительно)
forecast | прогноз
amend | изменить
soap | мыло
ruling | постановление
interference | помехи
executive | исполнительный
mining | добыча
minimal | минимальный
clarify | уточнить
strain | штамм
novel | Роман
try | попробуйте
coastal | прибрежных
rising | рост
quota | квота
kilometre | километр
characterise | описания
suspicious | подозрительные
pet | ПЭТ
beneficial | выгодно
fling | fling
deprive | лишить
covenant | завет
bias | предвзятость
trophy | трофей
verb | глагол
extract | экстракт
straw | солома
stem | стволовые
eyebrow | бровь
noble | благородный
mask | маска
lecturer | преподаватель
girlfriend | подруга
forehead | лоб
timetable | расписание
symbolic | символическое
farming | земледелие
lid | крышка
librarian | библиотекарь
injection | инъекции
sexuality | сексуальность
irrelevant | неактуально
bonus | бонус
abuse | злоупотребление
thumb | палец
survey | опрос
ankle | лодыжка
psychologist | психолог
occurrence | наступления
profitable | выгодно
deliberate | умышленное
bow | лук
tribe | колена
representative | представитель
code | код
validity | срок действия
marble | мрамор
bow | лук
plunge | Плунге
maturity | погашения
hidden | скрытый
contrast | контраст
tobacco | табак
middle-class | среднего класса
grip | сцепление
clergy | духовенство
trading | торговля
passive | пассивный
decoration | украшения
racial | расовой
well | хорошо
embarrassment | смущение
sauce | соус
fatal | роковой
banker | banker
compensate | компенсации
make-up | make-up
seat | кресло
popularity | популярность
interior | интерьер
eligible | право
continuity | непрерывность
bunch | букет
hook | крючок
wicket | калитка
pronounce | произносить
ballet | балет
heir | наследник
insufficient | недостаточно
substitute | заменить
mysterious | таинственный
dancer | танцор
trail | след
caution | внимание
donation | пожертвование
added | добавил
weaken | ослабить
tyre | шины
sufferer | страдалец
managerial | управленческие
elaborate | разработки
restraint | сдержанность
renew | обновить
gardener | садовник
dilemma | дилемма
configuration | конфигурация
rear | задний
embark | отправьтесь
misery | несчастье
appreciation | признательность
radical | радикальные
diverse | разнообразные
revive | возродить
trip | поездки
lounge | гостиная
dwelling | жилье
parental | родительский
loyal | Лояльный
privatisation | приватизация
outsider | аутсайдер
forbid | запретить
prospective | перспективные
manuscript | рукопись
inherent | присущие
deem | считают
telecommunication | электросвязи
intermediate | промежуточные
worthwhile | стоит
calendar | календарь
basin | бассейна
rebuild | восстановить
pulse | пульс
suppress | подавить
predator | хищник
width | ширина
stiff | жесткая
spine | позвоночника
betray | предать
punish | наказать
stall | ларек
lifestyle | образ жизни
compile | компиляции
arouse | вызвать
headline | заголовок
divine | божественное
unpleasant | неприятно
sacred | священный
useless | бесполезно
cool | круто
tremble | дрожать
statue | статуя
obey | подчиняться
drunk | пьяный
tender | тендер
molecular | молекулярно
circulate | разослать
exploitation | эксплуатации
utterance | высказывания
linear | линейный
chat | чат
revision | редакция
distress | бедствия
spill | разлив
steward | стюард
knight | рыцарь
sum | сумма
semantic | семантические
selective | селективный
learner | учащийся
dignity | достоинства
senate | Сенат
grid | сетки
fiscal | финансовый
activate | активировать
rival | соперник
fortunate | повезло
jeans | джинсы
select | выберите
fitting | монтаж
commentator | комментатор
weep | плакать
handicap | гандикап
crush | crush
towel | полотенце
stay | пребывание
skilled | квалифицированных
defensive | оборонительные
calm | спокойствие
rain | дождь
pin | контактный
villa | вилла
rod | род
frontier | границы
enforcement | правоприменение
protective | защитные
philosophical | философские
lordship | лордство
disagree | не согласен
boyfriend | бойфренд
activist | активист
viewer | зритель
slim | slim
textile | Текстиль
mist | туман
harmony | гармония
deed | управление собственностью
merge | слияние
invention | изобретение
commissioner | комиссар
caravan | караван
bolt | болт
ending | конечное
publishing | публикации
gut | gut
stamp | штамп
map | карта
stroke | инсульт
shock | шок
rug | ковер
picture | изображения
slip | скольжения
praise | хвала
fine | штраф
monument | памятник
material | материал
garment | одежда
realm | царство
melt | - расплава
reproduction | репродукции
reactor | реактор
furious | в ярости
distinguished | уважаемые
characterize | характеризуют
pump | насос
probe | зонд
feedback | обратная связь
aspiration | стремление
suspect | подозревать
solar | солнечной
fare | тариф
carve | вырезать
qualified | квалифицированных
membrane | мембраны
dependence | зависимости
convict | осужденный
bacteria | бактерии
trading | торговля
ambassador | посол
wound | рана
drug | наркотиков
conjunction | связи
cabin | кабина
trail | след
shaft | вал
treasure | сокровище
inappropriate | неуместно
attribute | атрибут
liquid | жидкость
embassy | посольства
exemption | освобождение
array | массив
tablet | таблетка
sack | мешок
erosion | эрозия
bull | бык
warehouse | склад
unfortunate | несчастный
promoter | промоутер
compel | заставить
motivate | мотивировать
burning | сжигание
vitamin | витамин
sail | парус
lemon | лимон
foreigner | иностранец
powder | порошок
persistent | стойкие
bat | летучая мышь
ancestor | предок
mathematical | математические
compliance | соответствие
arch | АРКА
woodland | леса
serum | сыворотки
doubtful | сомнительные
doing | делать
coach | тренер
binding | обязательным
surrounding | окружающих
peer | peer
ozone | озон
mid | средний
invisible | невидимый
depart | отойдите
brigade | бригада
manipulate | манипулировать
consume | потреблять
temptation | искушение
intact | нетронутыми
glove | перчатка
aggression | агрессия
emergence | появление
stag | олень
coffin | гроб
clutch | сцепления
wit | остроумие
underline | подчеркнутый
trainee | стажер
scrutiny | контроля
follower | последователь
sterling | Стерлинг
tariff | тариф
bee | пчела
relaxation | отдых
negligence | халатность
sunlight | Солнечный свет
penetrate | проникнуть
knot | узел
temper | нрав
skull | череп
grind | грайнд
whale | Кит
throne | трон
supervise | контролировать
sickness | болезни
package | пакет
intake | потребление
inland | внутренних
beast | зверь
rear | задний
morality | мораль
competent | компетентные
sink | раковина
uniform | униформа
reminder | напоминание
optimistic | оптимистичный
bargain | сделка
respective | соответствующих
horizontal | горизонтальная
decisive | решающим
bless | благослови
bile | желчь
spatial | пространственное
bullet | пуля
respectable | респектабельный
convincing | убедительно
unacceptable | неприемлемо
confrontation | противостояние
paid | платные
joke | шутка
instant | мгновение
illusion | иллюзия
cheer | ура
congregation | общество
winning | выигрыш
wake | Звонок
toss | ТОСС
medium | средний
jewellery | ювелирные изделия
fond | люблю
alarm | сигнализация
guerrilla | Партизанская
dive | погружение
desire | желание
cooperation | сотрудничество
thread | резьба
prescribe | предписывать
calcium | кальций
redundant | избыточные
marker | маркер
chemist | аптека
mammal | млекопитающих
legacy | наследие
debtor | должник
testament | завет
tragic | трагические
silver | серебро
grin | улыбка
spectacle | зрелище
inheritance | наследство
heal | исцели
sovereignty | суверенитет
enzyme | фермент
host | хост
neighbouring | соседние
corn | кукуруза
layout | макет
dictate | диктуют
rip | rip
regain | восстановить
probable | вероятность
inclusion | включение
booklet | буклет
bar | бар
laser | лазер
fame | слава
bronze | бронза
mobile | мобильный
metaphor | метафора
complication | осложнение
narrow | узкий
old-fashioned | старомодный
chop | ЧОП
synthesis | синтез
diameter | диаметр
bomb | бомба
shed | пролить
fusion | fusion
trigger | триггер
printing | печать
onion | лук
dislike | нелюбовь
embody | воплотить
curl | curl
sunshine | солнце
sponsorship | спонсорство
rage | ярость
loop | петля
halt | остановить
bang | bang
toxic | токсичные
thinking | мышление
orientation | ориентация
likelihood | вероятность
up-to-date | up-to-date
polite | вежливы
apology | извинение
exile | ссылки
brow | лоб
miserable | несчастный
outbreak | вспышка
pump | насос
fuck | ебут
forecast | прогноз
timing | сроки
headmaster | директор
terrify | ужас
sigh | вздох
premier | премьер
joint | совместных
incredible | невероятные
gravity | Гравитация
regulatory | регулирования
cylinder | цилиндр
curiosity | любопытство
resident | резидент
narrative | рассказ
cognitive | познавательные
lengthy | длительный
gothic | готика
dip | dip
adverse | неблагоприятные
accountability | подотчетность
hydrogen | водород
gravel | гравий
willingness | готовность
inhibit | препятствуют
attain | достижения
specialise | специализируется
steer | рулевого управления
selected | выбран
like | как
confer | посоветоваться
usage | использование
portray | изобразить
planner | планировщик
manual | руководство
boast | похвастаться
unconscious | без сознания
jail | тюрьмы
fertility | рождаемость
documentation | документация
wolf | волк
patent | патент
exit | выход
corps | корпус
proclaim | объявите
multiply | умножать
brochure | брошюра
screen | экран
orthodox | Православной
locomotive | Локомотив
unaware | не знают
syndrome | синдром
reform | реформы
confirmation | подтверждение
printed | печати
curve | кривая
costly | дорого
underground | метро
territorial | территориальная
designate | назначить
comfort | комфорт
plot | участок
misleading | заблуждение
weave | переплетения
scratch | scratch
echo | эхо
endure | терпеть
verbal | словесные
stride | шаг
nursing | сестринский
exert | оказывать
compatible | совместимый
causal | причинная
mosaic | мозаика
manor | усадьба
implicit | неявная
fashionable | модные
valve | клапан
proceed | продолжить
sofa | диван
snatch | канифас
jazz | Джаз
patron | покровитель
provider | провайдер
interim | промежуточный
intent | намерение
chosen | выбрал
applied | прикладной
shiver | дрожь
pie | пирог
fury | ярость
abolition | отмена
soccer | футбол
corpse | труп
accusation | обвинение
kind | вид
nursing | сестринский
contempt | презрение
prevail | преобладают
murderer | убийца
liberal | либеральная
gathering | сбор
subjective | субъективные
disagreement | разногласие
cleaner | пылесос
boil | отварить
static | статический
scent | запах
civilian | гражданского
monk | монах
keyboard | клавиатура
hammer | Хаммер
despair | отчаяние
controller | контроллер
yell | крик
entail | влечет
cheerful | веселый
reconstruction | реконструкция
patience | терпение
habitat | Хабитат
queue | очереди
spectator | зритель
given | учитывая
purple | фиолетовый
outlook | outlook
genius | гений
dual | двойной
canvas | холст
grave | могила
pepper | перец
conform | соответствие
cautious | осторожный
dot | точка
conspiracy | заговор
butterfly | бабочка
sponsor | спонсор
rating | рейтинг
weird | странно
teenage | подростковые
salmon | лосось
recorder | диктофон
postpone | отложить
maid | горничная
furnish | представить
ethical | этические
bicycle | велосипед
sick | больной
sack | мешок
renaissance | Ренессанс
luxury | люкс
gasp | ГПБП
wardrobe | шкаф
native | родной
fringe | fringe
adaptation | адаптация
quotation | котировки
hunger | голод
enclose | заключите
disastrous | катастрофические
choir | хор
overwhelming | подавляющее
glimpse | проблеск
divorce | развод
circular | циркуляр
locality | местность
ferry | паром
balcony | балкон
sailor | моряк
precision | точность
desert | пустыня
dancing | танцы
alert | предупреждение
surrender | сдача
archive | архив
jump | прыжок
philosopher | философ
revival | возрождение
presume | полагать
node | узел
fantastic | фантастический
herb | травы
assertion | утверждение
thorough | тщательный
quit | бросить
grim | мрачный
fair | ярмарка
broadcast | широковещательный
annoy | раздражать
divert | переадресация
accelerate | ускорения
polymer | полимер
sweat | пот
survivor | выживший
subscription | подписка
repayment | погашение
anonymous | анонимные
summarise | обобщения
punch | пунш
lodge | lodge
landowner | помещик
ignorance | невежество
discourage | препятствовать
bride | невеста
depressed | депрессия
abbey | аббатство
quarry | карьера
archbishop | архиепископ
sock | носок
large-scale | масштабные
glare | блики
descent | спуск
stumble | спотыкаться
mistress | хозяйка
empty | пустой
prosperity | процветание
harm | вреда
formulation | разработки
atomic | атомной
agreed | согласовано
wicked | злой
threshold | порог
lobby | лобби
repay | погасить
varying | разной
track | трек
crawl | ползать
tolerate | терпеть
salvation | спасение
pudding | пудинг
counter | счетчик
propaganda | пропаганда
cage | клетка
broker | брокер
ashamed | стыдно
scan | сканирование
document | документ
apparatus | аппарат
theology | богословие
analogy | аналогия
performer | исполнитель
squadron | эскадрилья
sentiment | настроения
making | оформить
exotic | экзотические
dominance | доминирование
coherent | когерентные
placement | размещение
flick | Флик
colourful | красочные
mercy | милосердие
amuse | потешить
mainstream | мейнстрим
appraisal | оценки
torch | факел
intimate | интимные
gold | золото
arbitrary | произвольные
venture | предприятие
preservation | сохранение
shy | застенчивый
disclosure | раскрытие информации
lace | кружева
inability | неспособность
motif | мотив
listener | слушатель
hunt | охота
delicious | вкусный
term | срок
substitute | заменить
highway | шоссе
haul | улов
dragon | дракон
chair | стул
accumulate | накапливать
unchanged | без изменений
sediment | осадка
sample | образец
exclaim | воскликнуть : 
fan | вентилятор
volunteer | волонтер
root | корень
parcel | участок
psychiatric | психиатрическая
delightful | восхитительный
confidential | конфиденциальной
calorie | калорий
flash | flash
crowd | толпа
aggregate | совокупный
scholarship | стипендии
monitor | монитор
disciplinary | дисциплинарные
rock | рок
hatred | ненависть
pill | таблетки
noisy | шумный
feather | перо
lexical | лексическая
staircase | лестница
autonomous | автономный
viewpoint | точка зрения
projection | проекция
offensive | наступление
controlled | контролируемые
flush | флеш
racism | расизма
flourish | процветать
resentment | обида
pillow | подушку
courtesy | вежливость
photography | фотографии
monkey | обезьяна
glorious | славное
evolutionary | эволюционный
gradual | постепенное
bankruptcy | банкротство
sacrifice | жертва
uphold | поддерживать
sketch | эскиз
presidency | президентство
formidable | Грозный
differentiate | дифференцировать
continuing | продолжение
cart | тележки
stadium | стадион
dense | плотный
catch | улов
immigration | иммиграция
clarity | ясность
worm | worm
slot | слот
rifle | винтовка
screw | винт
harvest | урожай
foster | Фостер
academic | академическая
impulse | импульс
guardian | опекун
ambiguity | двусмысленность
triangle | треугольник
terminate | прекратить
retreat | отступление
pony | пони
outdoor | открытый
deficiency | дефицит
decree | указ
apologise | извиниться
yarn | пряжа
staff | персонал
renewal | обновления
rebellion | восстание
flour | мука
developed | разработаны
chorus | хор
ballot | голосования
appetite | аппетит
stain | пятно
notebook | ноутбук
homeless | бездомные
census | переписи
bizarre | bizarre
striking | поразительные
greenhouse | парниковых
part | часть
burial | погребение
embarrassed | смущенный
ash | пепел
actress | актриса
cassette | кассеты
privacy | конфиденциальность
fridge | холодильник
feed | корма
excess | превышение
calf | теленок
associate | связать
ruin | руины
drill | дрель
photograph | фотография
devoted | преданный
driving | вождение
memorandum | меморандум
default | по умолчанию
costume | костюм
variant | вариант
shatter | shatter
methodology | методология
frame | кадр
swell | зыбь
investigator | следователь
imaginative | творческие
bored | скучно
bin | бин
awake | проснулся
recycle | recycle
group | группы
enjoyment | наслаждение
contemporary | современные
texture | текстуры
donor | донор
bacon | бекон
sunny | Солнечный
stool | табурет
prosecute | преследовать
commentary | комментарий
bass | бас
sniff | нюхать
repetition | повторение
eventual | возможной
credit | кредит
suburb | пригород
organisational | организационные
newcomer | новичок
romance | романтика
film | фильм
experiment | эксперимент
daylight | дневной свет
warrant | ордер
fur | меха
parking | парковка
nuisance | неприятность
civilian | гражданского
foolish | глупо
bulb | лампы
balloon | воздушный шар
vivid | яркие
surveyor | топограф
spontaneous | спонтанный
biology | биология
injunction | предписание
appalling | ужасает
amusement | развлечения
aesthetic | эстетические
vegetation | растительность
stab | удар
rude | грубо
offset | смещение
thinking | мышление
mainframe | мейнфрейма
flock | стадо
amateur | любитель
academy | академии
shilling | шиллинг
reluctance | нежелание
velocity | скорость
spare | запасные
wartime | военное время
soak | замочите
rib | ребро
mighty | могучий
shocked | шокирован
vocational | профессиональной
spit | коса
gall | желчь
bowl | чаша
prescription | рецепт
fever | лихорадка
axis | оси
reservoir | водохранилище
magnitude | величина
rape | изнасилование
cutting | резка
bracket | кронштейн
agony | агония
strive | стремиться
pledge | залог
recipient | получатель
moor | Мавр
invade | вторгнуться
dairy | молочные
chord | Аккорд
shrink | термоусадочная
pillar | столб
washing | стиральная
warrior | воин
supervisor | руководитель
outfit | снаряжение
innovative | инновационные
dressing | гардероб
dispute | спор
jungle | джунгли
brewery | пивоваренный завод
adjective | прилагательное
straighten | выпрямите
restrain | сдерживать
monarchy | монархии
trunk | ствол
herd | стадо
deadline | крайний срок
tiger | тигр
supporting | поддержка
moderate | умеренный
kneel | опускаюсь на колени
ego | эго
ministerial | министров
bitch | сука
wheat | пшеница
stagger | шатаются
snake | змея
ribbon | лента
mainland | материк
fisherman | рыбак
unwilling | не желает
nationalism | национализм
knitting | вязание
irony | ирония
handling | обращение
desired | нужный
bomber | бомбардировщик
voltage | напряжение
toast | тост
feel | чувствовать
suffering | страдания
polish | польский
meaningful | значимые
waiter | официант
tease | дразнить
goat | козел
conceptual | концептуальные
ant | муравей
inflict | нанести
bowler | котелок
roar | рев
drain | слива
wrong | неправильный
galaxy | галактика
aluminium | алюминий
receptor | рецептор
preach | проповедовать
parade | парад
opposite | напротив
critique | критика
query | запрос
outset | начала
integral | интеграл
grammatical | грамматические
testing | тестирование
patrol | патруль
pad | блокнот
unreasonable | необоснованным
sausage | колбасы
criminal | уголовного
constructive | конструктивный
worldwide | по всему миру
highlight | выделите
doll | кукла
frightened | напуганный
biography | биография
vocabulary | словарь
offend | обидеть
accumulation | накопление
linen | белье
fairy | фея
disco | диско
hint | подсказка
ray | ray
pottery | керамика
immune | иммунная
retreat | отступление
master | мастер
injured | ранены
holly | Элфи
battle | битва
solidarity | солидарность
embarrassing | неловко
cargo | грузов
theorist | теоретик
preferred | привилегированные
dash | тире
total | Итого
reconcile | примирить
drill | дрель
credibility | доверие
copyright | авторское право
beard | борода
bang | bang
vigorous | энергичный
punch | пунш
prevalence | распространенность
uneasy | непростой
boost | увеличить
scrap | лом
fog | туман
faithful | верный
bounce | отказов
batch | партии
smooth | гладкая
sleeping | спящая
accord | Аккорд
vice-president | вице-президент
blast | взрыв
square | площадь
prohibit | запретить
brake | тормоза
asylum | убежище
obscure | безвестные
nun | монахиня
heap | кучи
rhetoric | риторика
privileged | привилегированные
liaison | связь
jockey | жокей
concrete | бетон
allied | союзников
rob | Роб
indulge | побалуйте
distort | исказить
viable | жизнеспособные
nucleus | ядро
exaggerate | преувеличивать
compact | компактный
nationality | гражданство
cast | литье
altar | жертвенник
refuge | убежище
mandatory | обязательным
authorise | зависимости
accomplish | достижения
startle | испуг
indigenous | коренных
retailer | ритейлер
compound | соединение
admiration | восхищение
absurd | абсурд
coincidence | совпадение
passport | паспорт
depot | депо
soften | смягчить
secretion | секреция
invoke | ссылаться
dirt | грязь
scared | страшно
mug | кружку
convenience | удобства
calm | спокойствие
optional | дополнительно
unsuccessful | неудачные
consistency | последовательности
umbrella | зонтик
solo | соло
hemisphere | полушария
extreme | экстремальных
brandy | бренди
belly | живот
attachment | вложение
wash | мыть
uncover | Открывай
treat | лечить
repeated | повторил
pine | сосна
offspring | потомство
communism | коммунизм
nominate | выдвижение
soar | парить
geological | Геологическое
frog | лягушка
donate | пожертвовать
co-operative | co-operative
innocence | невинность
housewife | домохозяйка
disguise | маскировка
demolish | сносить
counsel | адвокат
cord | шнур
semi-final | полуфинал
reasoning | рассуждения
inclined | наклонные
evoke | вызывают
courtyard | двор
arena | Арена
simplicity | простота
inhibition | ингибирование
frozen | замороженные
vacuum | вакуум
immigrant | иммигрант
bet | ставка
revenge | месть
jail | тюрьмы
helmet | шлем
unclear | непонятно
jerk | дрочить
disruption | срыв
attainment | достижения
sip | sip
program | программа
lunchtime | обед
cult | культ
chat | чат
accord | Аккорд
offering | предлагая
broadcast | широковещательный
secular | светские
overwhelm | ошеломить
momentum | импульс
infinite | бесконечный
manipulation | манипуляции
inquest | дознание
decrease | уменьшение
cellar | погреб
counsellor | советник
avenue | авеню
rubber | Резина
labourer | работник
lab | лаборатории
damn | черт
tense | напряженная
socket | гнездо
par | Номинальная
thrust | упорная
scenario | сценарий
slap | пощечина
recreation | отдых
rank | ранг
spy | spy
filter | фильтр
clearance | оформление
blessing | благословение
embryo | эмбрион
varied | разнообразные
predictable | предсказуемый
mutation | мутация
equal | равные
can | может
burst | взрыв
retrieve | получить
elder | старейшина
rehearsal | репетиция
optical | оптический
hurry | спешите
conflict | конфликт
combat | борьбе с
absorption | поглощения
ion | Ион
heroin | героин
bake | выпекать
x-ray | x-ray
vector | вектор
stolen | украден
sacrifice | жертва
robbery | грабеж
probe | зонд
organizational | организационные
chalk | мел
bourgeois | буржуа
villager | житель
morale | мораль
express | Экспресс
climb | восхождение
notify | уведомить
jam | джем
bureaucratic | бюрократическое
literacy | грамотность
frustrate | сорвать
freight | грузовые
clearing | очистка
aviation | авиации
legislature | законодательный орган
banana | банан
deploy | развернуть
passionate | страстная
monastery | монастырь
kettle | чайник
enjoyable | приятным
diagnose | диагностики
quantitative | количественные
distortion | искажение
monarch | монарх
glow | свечение
acquaintance | знакомство
handy | в использовании
deprivation | лишение
attacker | злоумышленник
assault | нападение
screening | скрининг
retired | в отставке
portable | портативный
hostage | заложники
jealous | ревнивый
proportional | пропорциональные
gown | платье
chimney | дымоход
bleak | мрачное
seasonal | сезонные
plasma | плазма
stunning | потрясающий
spray | спрей
referral | направление
fluctuation | колебание
decorative | декоративные
unrest | беспорядки
resent | возмущен
plaster | штукатурки
chew | жевать
grouping | группировка
gospel | Евангелие
distributor | дистрибьютор
differentiation | дифференциация
blonde | блондинка
aquarium | аквариум
witch | ведьма
renewed | обновленный
jar | jar
approved | утверждены
advocate | адвокат
worrying | беспокойство
minimise | минимизации
footstep | шаги
delete | удалить
lone | одинокий
level | уровень
drift | дрейф
spider | паук
hectare | гектар
colonel | полковник
swimming | плавание
realism | реализм
insider | инсайдер
hobby | хобби
computing | вычислительных
infrastructure | инфраструктура
co-operate | сотрудничать
burn | сжечь
cereal | крупы
fold | раз
compromise | компромисс
boxing | бокс
rear | задний
lick | лизнуть
constrain | ограничить
clerical | канцелярский
hire | Прокат
contend | утверждаю
amateur | любитель
instrumental | инструментальная
terminal | терминал
electorate | электорат
congratulate | поздравляю
balanced | сбалансированная
manufacturing | производство
split | сплит
domination | доминирование
blink | мигает
bleed | кровотечение
unlawful | незаконными
precedent | прецедент
notorious | пресловутый
indoor | Крытый
upgrade | обновления
trench | траншеи
therapist | терапевт
illuminate | освещения
bargain | сделка
warranty | гарантия
scar | шрам
consortium | консорциум
anger | гнев
insure | застраховать
spoon | ложка
enhanced | расширенные
disrupt | нарушить
satisfied | удовлетворены
precaution | меры предосторожности
kite | воздушный змей
instant | мгновение
gig | концерт
consolidate | консолидация
fountain | фонтан
graduate | выпускник
gloom | мрак
bite | укус
structure | структура
noun | существительное
nomination | номинации
armchair | кресло
virtual | виртуальный
unprecedented | беспрецедентная
tumble | прыгаем
ski | мотоцикл
architectural | архитектурные
violation | нарушение
rocket | ракета
inject | инъекционные
departmental | ведомственные
row | строки
luxury | люкс
fax | Факс
deer | олень
climber | альпинист
photographic | фотографические
haunt | преследовать
dining | столовая
sodium | натрия
gossip | сплетни
bundle | узелок
bend | согните
recruit | рекрут
hen | курица
fragile | хрупкий
deteriorate | ухудшаться
dependency | зависимости
swift | swift
scramble | схватка
overview | обзор
imprison | сажать в тюрьму
trolley | столик
rotation | вращения
denial | отказ
boiler | котел
amp | усилитель
trivial | тривиальный
shout | крик
overtake | обгонять
make | сделать
hunter | охотник
guess | думать
syllable | слог
obscure | безвестные
mould | плесень
limestone | известняк
leak | утечки
beneficiary | получатель
veteran | ветеран
surplus | профицит
manifestation | проявление
vicar | викарий
textbook | учебник
novelist | писатель
contractual | договорные
swap | своп
guild | гильдии
ulcer | язва
slab | плиты
detector | детектор
detection | обнаружения
cough | кашель
spelling | орфография
lender | кредитор
glow | свечение
raised | поднял
prolonged | продолжительный
voucher | ваучер
t-shirt | t-shirt
linger | задерживаться
humble | смиренный
honey | мед
scream | крик
postcard | открытка
managing | управление
alien | иностранец
trouble | беда
reverse | реверс
odour | запах
discount | скидка
blast | взрыв
syntactic | синтаксические
scrape | царапина
residue | остаток
procession | процессия
pioneer | Пионер
intercourse | общение
deter | удержать
deadly | смертельная
complement | дополнения
restrictive | ограничительные
nitrogen | азот
citizenship | гражданство
pedestrian | пешеход
detention | задержание
wagon | вагон
microphone | микрофон
fixture | светильник
choke | дроссель
wet | мокрые
weed | сорняк
programming | программирование
power | питание
dozen | десяток
carrot | морковь
bulletin | бюллетень
wording | формулировка
vicious | порочный
urgency | актуальность
spoken | говорил
skeleton | скелет
motorist | автомобилист
interactive | интерактивный
compute | вычислить
whip | кнут
telly | телик
shrub | кустарник
porter | Портер
ethics | этика
banner | баннер
velvet | бархат
omission | бездействие
hook | крючок
gallon | галлон
superintendent | инспектор
plug | разъем
continuation | продолжение
reliance | опора
justified | оправдан
fool | дурак
detain | задержать
damaging | повреждения
orbit | орбита
mains | электросеть
discard | отменить
dine | поужинать
compartment | отсек
revised | пересмотренный
privatization | приватизация
memorable | памятные
distributed | распределенная
disperse | разогнать
blame | винить
basement | подвал
slump | спад
puzzle | головоломка
monitoring | мониторинг
talented | талантливые
nominal | Номинальная
mushroom | гриб
instructor | инструктор
fork | вилка
board | доска
want | хотите
disposition | диспозиция
cemetery | кладбище
attempted | попытка
nephew | племянник
magical | волшебный
ivory | слоновой кости
hospitality | гостеприимство
astonishing | удивительное
tract | тракта
proprietor | владелец
license | лицензии
differential | дифференциал
affinity | близость
talking | говорить
royalty | роялти
neglect | пренебрежение
irrespective | независимо
whip | кнут
sticky | sticky
regret | сожаление
incapable | недееспособным
franchise | франшиза
dentist | стоматолог
contrary | отличие
profitability | рентабельность
enthusiast | энтузиаст
crop | урожай
utter | звучание
pile | сваи
pier | Пирс
dome | купол
bubble | пузырь
treasurer | казначей
stocking | чулок
sanctuary | святилище
ascertain | установить
arc | дуги
quest | квест
mole | моль
marathon | марафон
feast | праздник
crouch | Крауч
storm | шторм
hardship | трудности
entitlement | право
circular | циркуляр
walking | ходьба
strap | ремень
sore | боль
complementary | взаимодополняющие
understandable | понятно
noticeable | заметно
mankind | человечество
majesty | Величество
pigeon | голубь
goalkeeper | вратарь
ambiguous | двусмысленные
walker | Уокер
virgin | Дева
prestige | престиж
preoccupation | озабоченность
upset | расстроен
municipal | муниципальных
groan | стон
craftsman | ремесленник
anticipation | предвкушение
revise | пересмотреть
knock | стук
infect | заразить
denounce | денонсировать
confession | исповедь
turkey | Турция
toll | отдел
pal | pal
transcription | транскрипция
sulphur | серы
provisional | предварительная
hug | обнять
particular | частности
intent | намерение
fascinate | очаровывать
conductor | дирижер
feasible | это осуществимо
vacant | вакантных
trait | черта
meadow | луг
creed | символ веры
unfamiliar | незнакомые
optimism | оптимизм
wary | осторожный
twist | твист
sweet | сладкий
substantive | основное
excavation | раскопки
destiny | судьба
pasture | пастбище
archaeological | археологические
tick | тик
profit | прибыль
pat | Пат
papal | папский
cultivate | культивировать
awake | проснулся
trained | обучение
civic | гражданской
voyage | путешествие
siege | осада
distract | отвлекают
stroll | прогулка
jewel | драгоценность
honourable | почетный
helpless | беспомощный
hay | сено
expel | высылать
eternal | вечной
demonstrator | демонстратор
correction | коррекция
civilization | цивилизации
ample | широкие
retention | удержание
rehabilitation | реабилитация
premature | преждевременная
encompass | охватывает
diplomat | дипломат
articulate | сформулировать
restricted | ограничен
prop | prop
intensify | активизировать
deviation | отклонение
contest | конкурс
workplace | на рабочем месте
lazy | ленивый
kidney | почки
insistence | настойчивость
whisper | шепот
multimedia | мультимедиа
forestry | лесное хозяйство
excited | возбужденный
decay | распад
screw | винт
rally | ралли
pest | вредитель
invaluable | бесценный
homework | домашнее задание
harmful | вредных
bump | шишка
bodily | телесные
grasp | понять
finished | закончил
facade | фасад
cushion | подушки
urge | призываю
tune | мелодия
solvent | растворитель
slogan | лозунг
petty | мелкие
perceived | воспринимается
install | установить
fuss | суета
rack | стойка
imminent | непосредственная
short | короткий
revert | вернуться
ram | ОЗУ
contraction | сокращение
tread | протектора
supplementary | дополнительные
ham | ветчина
defy | игнорировать
athlete | спортсмен
sociological | социологические
physician | врач
crossing | пересечения
bail | залог
unwanted | нежелательных
plausible | правдоподобно
midfield | полузащита
alert | предупреждение
feminine | женский
drainage | дренаж
cruelty | жестокость
abnormal | аномальное
relate | относятся
symmetry | симметрия
stake | доля
rotten | гнилой
prone | склонной
marsh | марш
litigation | судебные разбирательства
curl | curl
urine | исследование мочи
latin | Латинская
hover | hover
greeting | приветствие
chase | погоня
spouse | супруга
produce | производим
forge | forge
salon | салон
handicapped | прием
sway | раскачивания
homosexual | гомосексуалист
handicap | гандикап
colon | Колон
upstairs | наверх
stimulation | стимуляция
spray | спрей
original | оригинал
lay | лежал
garlic | чеснок
suitcase | чемодан
skipper | шкипер
moan | стон
manpower | рабочей силы
manifest | манифест
decision-making | принятия решений
reformer | реформатор
quantum | квантовая